Accademie e Biblioteche d'Italia	ABI
Acta Ethnographica Academiae Scientiarum Hungaricae	AEASH
Acta Germanica: Jahrbuch des Germanistenverbandes im Südlichen Afrika	ActaG
Acta Linguistica Hafniensia: International Journal of General Linguistics	ALH
Acta Universitatis Szegediensis de Attila József Nominatae: Sectio Ethnographica et Linguistica/Néprajz és Nyelvtudomány/Volkskunde und Sprachwissenschaft	AUS-E&L
L'Action Nationale	ActN
Adalbert Stifter Institut des Landes Oberösterreich: Vierteljahresschrift	ASILO
ADE Bulletin	ADEB
ADFL Bulletin	ADFLB
Aevum: Rassegna di Scienze Storiche, Linguistiche, Filologiche	Aevum
Africa: Journal of the International African Institute/Revue de l'Institut Africain International	AfricaL
Africa Report	AfricaR
Africa: Rivista Trimestrale di Studi e Documentazione dell'Istituto Italo-Africano	Africa
African American Review	AAR
African Arts	AfrA
The African Book Publishing Record	ABPR
African Notes: Journal of the Institute of African Studies	AfrN
African Studies	AfrS
The African Studies Review	AfrSR
African Writers Series	AfrWS
Africana Journal: A Bibliographic Library Journal and Review Quarterly	AfrLJ
Africana Linguistica	AfrL
Afrika Focus	AfrF
L'Afrique Littéraire	ALA
Afro-Hispanic Review	AHR
The Age of Johnson: A Scholarly Annual	AJ
Agenda	Agenda
Agora: A Journal in the Humanities and Social Sciences	Agora
AILA Review	AILAR
Aiolika Grammata	AiolikaG
Akademiska Dzïve	ADz
Akzente: Zeitschrift für Literatur	Akzente
Al'manakh Ukraïns'koho Narodnoho Soiuzu	AUNS
Al- Qantara: Revista de Estudios Arabes	Qantara
Alaluz: Revista de Poesia, Narracion y Ensayo	Alaluz
Alba de América: Revista Literaria	AldeAm
Alföld: Irodalmi Muvelodési és Kritikai Folyóirat	Alföld
Alif: Journal of Comparative Poetics	Alif
The Aligarh Journal of English Studies	AJES
L'Alighieri: Rassegna Bibliografica Dantesca	Alighieri
Alizés: Revue Angliciste de la Réunion	Alizés
Altro Polo: A Volume of Italian Studies	AlP
Amerasia Journal	AmasJ
American Anthropologist	AA
American Benedictine Review	ABR
American Book Collector	ABC
American Indian Quarterly	AIQ
American Journal of Germanic Linguistics and Literatures	AJGLL
The American Journal of Psychoanalysis	AJP
The American Journal of Semiotics	AJS
American Literary History	AmLH
American Literary Realism, 1870-1910	ALR
American Literary Scholarship: An Annual	AmLS
American Literature: A Journal of Literary History, Criticism, and Bibliography	AL
American Periodicals: A Journal of History, Criticism, and Bibliography	AmPer
The American Poetry Review	APR
American Psychologist	AmP
American Quarterly	AQ
The American Scholar	ASch
The American Sephardi: Journal of the Sephardic Studies Program of Yeshiva University	AmSeph
American Speech: A Quarterly of Linguistic Usage	AS
American Studies	AmerS
American Studies International	ASInt
American Transcendental Quarterly	ATQ
American Translators Association Series	ATAS
American University Studies I: Germanic Languages and Literature	GLL
American University Studies II: Romance Languages and Literature	RLL
American University Studies III: Comparative Literature	CompL
American University Studies IV: English Language and Literature	EL&L
American University Studies XII: Slavic Languages and Literature	SL&Li
American University Studies XIII: Linguistics	Ling
American University Studies XIX: General Literature	GenL
American University Studies XVIII: African Literature	AfrLit
American University Studies XXII: Latin American Literature	LatAL
American University Studies XXIV: American Literature	AmLit
The Americas Review: A Review of Hispanic Literature and Art of the USA	AmRev
Amerikastudien/American Studies	Amst
Amerikastudien/American Studies: A Monograph Series	AmStudies
Ameryka: A Ukrainian Catholic Daily	Ameryka
Amitié Charles Péguy: Bulletin d'Informations et de Recherches	ACP
AMS Studies in the Eighteenth Century	AMSS
AMS Studies in the Middle Ages	AMSSMA
AMS Studies in the Renaissance	AMSR
Amstelodamum: Maandblad voor de Kennis van Amsterdam. Orgaan van Het Genootschap Amstelodamum	Amstel
Amsterdam Studies in the Theory and History of Linguistic Science V: Library and Information Sources in Linguistics	LISL
Amsterdamer Beiträge zur Neueren Germanistik	ABnG
Amsterdamer Publikationen zur Sprache und Literatur	APSL
Anais: An International Journal	Anais
Analecta Bollandiana	AnBol
Analecta Malacitana: Revista de la Seccion de Filología de la Facultad de Filosofia y Letras	AnMal
Analecta Sacra Tarraconensia: Revista de Ciencias Historico-Eclesiasticas Balmesiana	AnST
Analele Stiintifice ale Universitatii "Al.I. Cuza" din Iasi (Serie noua), e. Lingvistica	ASUI
Anales Cervantinos	ACer
Anales de la Literatura Española Contemporánea	ALEC
Anales de Literatura Española	ALE
Anales Galdosianos	AGald
Analytical & Enumerative Bibliography	AEB
Angelicum: Periodicum Trimestre Pontificae Studiorum Universitatis a Sancto Thoma Aquinate in Urbe	Angelicum
Anglia: Zeitschrift für Englische Philologie	Anglia
Anglistik & Englischunterricht	A&E
Anglistische Forschungen	AF
Anglo-American Forum	AAF
Anglo-Saxon England	ASE
Annales Academiae Scientiarum Fennicae. Dissertationes Humanarum Litterarum	AASF
Annales Academiae Scientiarum Fennicae/Suomalaisen Tiedeakatemian Toimituksia	AASFB
Annales de Bretagne et des Pays de l'Ouest	AnBret
Annales de la Faculté des Lettres et Sciences Humaines de Yaoundé/Annals of Faculty of Letters and Social Sciences of Yaounde	AFLSHY
Annales du Midi: Revue de la France Méridionale	AdM
Annali d'Italianistica	AdI
Annali del Liceo Classico "G. Garibaldi" di Palermo	ALCGP
Annali della Facoltà di Lettere e Filosofia dell'Università do Perugia	AFLFP
Annali della Scuola Normale Superiore di Pisa: Classe di Lettere e Filosofia	ASNSP
Annali di Ca' Foscari: Rivista della Facoltà di Lingue e Letterature Straniere dell'Università di Venezia	ACF
Annali Istituto Universitario Orientale, Napoli, Sezione Romanza	AION-SR
Annals of Scholarship: An International Quarterly in the Humanities and Social Sciences	AnSch
Annals of the Bhandarkar Oriental Research Institute	ABORI
Annals of the New York Academy of Sciences	ANYAS
Annual Review of Applied Linguistics	ARAL
ANQ: A Quarterly Journal of Short Articles, Notes and Reviews	ANQ
Anthropologica	Anthropologica
Anthropological Linguistics	AnL
Anthropological Quarterly	AntQ
Anthropos: International Review of Ethnology and Linguistics	Anthropos
Anthropos: Revista de Documentación Científica de la Cultura	AnthroposS
The Antigonish Review	AntigR
The Antioch Review	AR
Antonianum	Antonianum
Anuar de Lingvistica si Istorie Literara	ALIL
Anuario de Estudios Filologicos	AEFil
Appalachiam Journal: A Regional Studies Review	AppalJ
Applied Linguistics	AppLing
Applied Psycholinguistics	APsy
Arabica: Revue d' Etudes Arabes	Arabica
Arbeiten aus Anglistik und Amerikanistik	ArAA
Arbor: Ciencia, Pensamiento y Cultura	Arbor
Arcadia: Zeitschrift für Vergleichende Literaturwissenschaft	Arcadia
Archiv für das Studium der Neueren Sprachen und Literaturen	Archiv
Archiv für Geschichte der Philosophie	AGP
Archiv für Geschichte des Buchwesens	AGB
Archiv für Kulturgeschichte	AKG
Archiv für Reformationsgeschichte	ARG
Archivio Glottologico Italiano	AGI
Archivo Storico di Belluno, Feltre e Cadore	ASBFC
Archivs: Raksti par Latviskam Problemam	Archivs
Archivum Franciscanum Historicum	AFH
Archivum Latinitatis Medii Aevi (Bulletin du Cange)	ALMA
Area and Culture Studies	A&CS
Arheologija un Etnografija	AuE
Ariel	ArielK
Ariel: A Review of Arts and Letters in Israel	Ariel
Ariel: A Review of International English Literature	ArielE
Arizona Quarterly: A Journal of American Literature, Culture, and Theory	ArQ
The Arkansas Quarterly: A Journal of Criticism	ArkQ
Arkiv för Nordisk Filologi/Archives for Scandinavian Philology	ANF
Armchair Detective: A Quarterly Journal Devoted to the Appreciation of Mystery, Detective, and Suspense Fiction	ArmD
The Arthurian Yearbook	ArthY
Arv: Scandinavian Yearbook of Folklore	Arv: Scandinavian Yearbook of Folklore
Asemka: A Literary Journal of the University of Cape Coast	Asemka
Asia Major	AsMj
Asian and African Studies	AAS
Asian Folklore Studies	AFS
Asian Music: Journal of the Society for Asian Music	AMus
Asian Theater Journal	ATJ
Asiatische Studien/Etudes Asiatiques: Zeitschrift der Schweizerischen Asiengesellschaft/Revue de la Société Suisse-Asie	ASEA
Assaph: Studies in the Theater	Assaph
Assays: Critical Approaches to Medieval and Renaissance Texts	Assays
Association for Recorded Sound Collections Journal	ARSCJ
L'Astrado: Revisito Bilengo de Prouvènço/Revue Bilinque de Provence	Astrado
Atenea: Revista de Ciencia, Arte y Literatura de la Universidad de Concepción	Atenea
Ateneo Veneto: Rivista di Scienze, Lettere ed Arti	AV
Athanor	Athanor
Athenaeum: Studi Periodici di Letteratura e Storia dell'Antichità	Athenaeum
Atlantis: A Women's Studies Journal/Journal d'Etudes sur la Femme	Atlantis
Atti del Sodalizio Glottologico Milanese	ASGM
Atti della Accademia Nazionale dei Lincei. Rendiconti della Classe di Scienze Morali, Storiche e Filologiche	ANLMSF
Augustan Reprint Society	ARS
Augustinianum	Augustinianum
Augustinus: Quarterly Review of The Fathers Augustinian Recollects	Augustinus
AUMLA: Journal of the Australasian Universities Language and Literature Association: A Journal of Literary Criticism and Linguistics	AUMLA
Aurora: Jahrbuch der Eichendorff Gesellschaft	Aurora: Jahrbuch der Eichendorff Gesellschaft
Ausblick: Zeitschrift für Deutsch-Skandinavische Beziehungen	Ausblick
Australasian Drama Studies	ADS
Australian Journal of French Studies	AJFS
Australian Journal of Linguistics: Journal of the Australian Linguistic Society	AJL
Australian Literary Studies	ALS
Australian Slavonic & East European Studies	ASEES
Authoritative Studies in World Literature	ASWL
Aztlán: A Journal of Chicano Studies	Aztlán
Babel: Revue Intérnationale de la Traduction/International Journal of Translation	Babel
The Baker Street Journal: An Irregular Quarterly of Sherlockiana	BSJ
Balcanica: Annuaire de l'Institut des Etudes Balkaniques	Balcanica: Annuaire de l'Institut des Etudes Balkaniques
Balkan Studies	BalSt
Balkansko Ezikoznanie/Linguistique Balkanique	BEz
Baltische Hefte	BHe
Baltistica: Baltu Kalbu Tyrinejimai	Baltistica
Banasthali Patrika	BP
Barroco	Barroco
The Baum Bugle	BaumB
Bayerische Akademie der Wissenschaften. Philosophisch-Historische Klasse, Sitzungsberichte	BAWS
Beckettiana: Cuadernos del Seminario Beckett	Beckettiana
Behavior Research and Therapy: An International Multi-Disciplinary Journal	BRT
Beiträge zur Geschichte der Deutschen Sprache und Literatur	BGDSL
Beiträge zur Namenforschung	BN
Beiträge zur neueren Literaturgeschichte	BNL
Belaruskaia Linhvistyka	BelL
Belaruskaia Mova: Mizhvuzauski Zbornik	BMM
Belfagor: Ressegna di Varia Umanità	Belfagor
Bergomum: Bollettino della Civica Biblioteca	Bergomum: Bollettino della Civica Biblioteca
Bestia: Yearbook of the Beast Fable Society	Bestia
Bharatiya Vidya	BhV
Biblical Archaeologist	BibA
Biblio 17	Biblio 17
Bibliofilia: Rivista di Storia del Libro e di Bibliografia	Bibliofilia
Biblioteca della Ricerca: Testi Stranieri	BRTS
Biblioteca/The Library: Monthly Journal for Bibliography	Biblioteca
Biblioteka Analiz Literackich	BALit
Bibliotheca Afroasiatica	BAFAS
The Bibliotheck: A Scottish Journal of Bibliography and Allied Topics	Bibliotheck
Bibliothèque d'Humanisme et Renaissance	BHR
Bijdragen tot de Taal-, Land- en Volkenkunde	BTLV	
Bikoret u-Parshanut: Ketav-'et le-Sifrut, Lashon, Historiah ve-Estetikah	Bikoret u-Parshanut
The Bilingual Review/La Revista Bilingüe	BR/RB
Biography: An Interdisciplinary Quarterly	Biography
Bitzaron: Quarterly Review of Hebrew Letters/Riv'on Sifrut, Hagut, Mehkar	Bitzaron
Biuletyn Polonistyczny: Kwartalnik	BiP
Biuletyn Polskiego Towarzystwa Jezykoznawczego/Bulletin de la Société Polonaise de Linguistique	BPTJ
Black Orpheus: Journal of African and Afro-American Literature	BO
Black Warrior Review	BWR
Blake: An Illustrated Quarterly	Blake
Bluegrass Unlimited	BGU
Blues Unlimited	BU
Bodleian Library Record	BLR
Bokvännen	Bokvännen
Boletim de Filologia	BdF
Boletin Cultural y Bibliografico	BCB
Boletín de Filología	BFil
Boletín de la Academia Norteamericana de la Lengua Española	BANLE
Boletín de la Biblioteca de Menéndez Pelayo	BBMP
Boletín de la Fundación Federico García Lorca	BFFGL
Boletín de la Real Academia Española	BRAE
Boletín del Real Instituto de Estudios Asturianos	BIEA
Bollettino del Centro di Studi Vichiani	BCSV
Bollettino della Domus Mazziniana	BDM
Bonniers Litterära Magasin	BLM
The Book Collector	BC
Book Forum: An International Transdisciplinary Quarterly	BForum
Books at Brown	BBr
Books at Iowa	BI
Books from Finland	BF
Books in Bosnia and Herzegovina: A Yugoslav Literary Journal	BBH
Boston Review	BRev
Botswana Notes and Records	BN&R
Boundary 2: An International Journal of Literature and Culture	BoundaryII
Brahmavidya, The Adyar Library Bulletin	AdLB
Brain and Language	B&L
Brasil/Brazil: Revista de Literatura Brasileira/A Journal of Brazilian Literature	BslBzl
Braunschweiger Anglistische Arbeiten	BAA
The Brecht-Yearbook/Das Brecht-Jahrbuch	BrechtJ
Bridges: A Senegalese Journal of English Studies/Revue Sénégalaise d'Etudes Anglaises	Bridges
Brigham Young University Studies	BYUS
British Journal of Aesthetics	BJA
British Journal of Psychology	BJP
The British Library Journal	BLJ
Brontë Society Transactions	BST
Brotéria: Cultura e Informação	Brotéria
Bucknell Review: A Scholarly Journal of Letters, Arts and Sciences	BuR
Bulgarski Ezik: Organ na Instituta za Bulgarski Ezik pri Bulgarskata Akademiia na Naukite	BE
Bulletin Bibliographie de la Société Internationale Arthurienne	BBSIA
Bulletin CILA: Organe de la Commission Interuniversitaire Suisse de Linguistique Appliquée	BCILA
Bulletin de Correspondance Hellénique	BCH
Bulletin de l'Académie Royale de Langue et de Littérature Françaises	BARLLF
Bulletin de l'Association des Amis de Rabelais et de La Devinière	BAR
Bulletin de l'Association Guillaume Budé	BAGB
Bulletin de la Société Américaine de Philosophie de Langue Française	BSAPLF
Bulletin de la Société d'Etudes Anglo-Américaines des XVIIe et XVIIIe Siècles	BSEAA
Bulletin de la Société de Linguistique de Paris	BSLP
Bulletin de la Société des Amis de Montaigne	BSAM
Bulletin de la Société Théophile Gautier	BSTG
Bulletin de Littérature Ecclésiatique	BLE
Bulletin des Amis d'André Gide	BAAG
Bulletin Hispanique	BH
Bulletin Marcel Proust	BMP
Bulletin of Bibliography	BB
Bulletin of Hispanic Studies	BHS
Bulletin of the Cantiguerios de Santa Maria	BCSM
Bulletin of the Comediantes	BCom
Bulletin of the John Rylands University of Manchester	BJRL
Bulletin of the Museum of Far Eastern Antiquities	BMFEA
Bulletin of the Psychonomic Society	BPS
Bulletin of the School of Oriental and African Studies	BSOAS
The Bulletin of the West Virginia Association of College English Teachers	BWVACET
Bungaku	BG
The Byron Journal	ByronJ
Byzantinische Zeitschrift	BZ
Byzantinoslavica: Review Internationale des Etudes Byzantines	BSI
Byzantion: Revue International des Etudes Byzantines	Byzantion
Cadernos de Estudos Lingüísticos	CEL
Cadernos de Lingüística e Teoria da Literatura	CLTL
Cahiers Charles V	CCV
Cahiers Confrontation	CCon
Cahiers CRLH-CIRAOI	CCRLH
Cahiers d'Etudes Africaines	CEAfr
Cahiers d'Etudes Mongoles et Siberiennes	EMong
Cahiers de Civilisation Médiévale (Xe-XIIe Siècles)	CCM
Cahiers de l'Association Internationale des Etudes Françaises	CAIEF
Cahiers de l'Institut de Linguistique de Louvain	CdIL
Cahiers de Lexicologie	CdL
Cahiers du Monde Hispanique et Luso-Brésilien/Caravelle	CMHLB
Cahiers du Monde Russe et Soviétique	CMRS
Cahiers Elisabéthains: Late Medieval and Renaissance Studies	CahiersE
Cahiers Ferdinand de Saussure: Revue de Linguistique Générale	CFS
Cahiers Gérard de Nerval	CGN
Cahiers Internationaux de Symbolisme	CIS
Cahiers Jean Giraudoux	CJG
Les Cahiers Naturalistes	CNat
Cahiers Roumains d'Etudes Littéraires: Revue Trimestrielle de Critique, d'Esthétique et d'Histoire Littéraires	CREL
Cahiers Saint-John Perse	CSJP
Cahiers Simone Weil	CSW
Cahiers Victoriens et Edouardiens: Revue du Centre d'Etudes et de Recherches Victoriemmes et Edouardiennes de l'Université Paul Valéry, Montpellier	CVE
Caliban	Caliban
California Slavic Studies	CalSS
Callaloo: A Journal of African-American and African Arts and Letters	Callaloo
Cambridge Applied Linguistics Series	CALS
Cambridge Medieval Celtic Studies	CMCS
The Cambridge Quarterly	CQ
Cambridge Studies in French	CSF
Cambridge Studies in Latin American and Iberian Literature	CSLAIL
Cambridge Studies in Linguistics	CSL
Camera Obscura: A Journal of Feminism and Film Theory	CamObsc
Campi Immaginabili: Rivista Quadrimenstrale di Cultura	CImm
Canadian-American Slavic Studies	CASS
Canadian Ethnic Studies/Etudes Ethniques au Canada	CEStudies
Canadian Folk Music Bulletin	CFMB
Canadian Folk Music Journal	CFMJ
Canadian Folklore Canadien	CFolkC
Canadian Journal of African Studies/Revue Canadienne des Etudes Africaines	CJAS
Canadian Journal of Irish Studies	CJIS
Canadian Journal of Italian Studies	CJItS
Canadian Journal of Linguistics/Revue Canadienne de Linguistique	CJL
Canadian Journal of Netherlandic Studies/Revue Canadienne d'Etudes Néerlandaises	CJNS
Canadian Journal of Philosophy	CJPhil
Canadian Literature	CanL
Canadian Modern Language Review/La Revue Canadienne des Langues Vivantes	CMLR
Canadian Poetry: Studies, Documents, Reviews	CanPo
Canadian Review of American Studies	CRevAS
Canadian Review of Comparative Literature/Revue Canadienne de Littérature Comparée	CRCL
Canadian Slavonic Papers: An Inter-Disciplinary Quarterly Devoted to Central and Eastern Europe	CSP
Canadian Theatre Review	CTR
CARA: Actes du Centre Aixois de Recherches Anglaises	CARA
Cardozo Studies in Law and Literature	CSLL
Carleton Papers in Applied Language Studies	CPALS
The Carlyle Annual	CAnn
Carte Italiane: A Journal of Italian Studies	CarteI
Casa de las Américas	CasaA
Casopis pro Moderní Filologii	CMF
Castilla: Boletín del Departamento de Literatura Española	Castilla
Castrum Peregrini	CPe
Cather Studies	CathSt
Cauda Pavonis: Studies in Hermeticism	CaudaP
CEA Critic: An Official Journal of the College English Association	CEA
Celestinesca: Boletín Informativo Internacional	Celestinesca
Celtica	Celtica
Cenobio: Revista Trimestrale di Cultura	Cenobio
The Centennial Review	CentR
Central Asiatic Journal: International Periodical for the Languages, Literature, History and Archeology of Central Asia	CAsJ
Central Institute of English and Foreign Languages Bulletin	CIEFLB
Centro de Estudios Mayas-Cuadernos	CEMC
Cercetari de Lingvistica	CLing
Cervantes: Bulletin of the Cervantes Society of America	Cervantes
Ceský Lid: Národopisný Casopis/Ethnological Journal	CLid
Ceská Literatura: Casopis pro Literární Vedu	CL
Champs du Signe: Cahiers de Stylistique	ChSigne
Chasqui: Revista de Literatura Latinoamericana	Chasqui
The Chaucer Review: A Journal of Medieval Studies and Literary Criticism	ChauR
The Chesterton Review: The Journal of the Chesterton Society	CRev
Chiba Review	Chiba R
Chicago Review	ChiR
Child Development	CD
Child Language Teaching and Therapy	CLTT
Children's Literature: An International Journal, Inc. Annual of the Modern Language Association Division on Children's Literature and the Children's Literature Association	ChildL
Children's Literature Association Quarterly	CLAQ
Chinese Culture: A Quarterly Review	ChC
Chinese Literature	ChinL	
Chinese Literature: Essays, Articles, Reviews	CLEAR
Chiricú	Chiricú
Chloe: Beihefte zum Daphnis	Chloe: Beihefte zum Daphnis
Christian Scholar's Review	CSR
Christianity and Literature	C&L
Chronique d'Egypte	ChrE
Chu-Shikoku Studies in American Literature	SALit
Chugoku Bungaku Ho	CBunH
Chung-wai Literary Monthly: Studies in Chinese and Foreign Literatures	CWLM
CICIM: Revue pour le Cinéma Français	CICIM
Ciencia Tomista: Publicación Cuatrimestral del Centro de Estudios Teológicos de San Esteban	CT
Cimarron Review	CimR
Cineaste: America's Leading Magazine on the Art and Politics of the Cinema	Cineaste
Cinema Journal	CinJ
Città di Vita: Bimestrale di Religione Arte e Scienza	CV
La Ciudad de Dios: Revista Agustiniana	CdD
The Claflin College Review	CCR
Classical and Modern Literature: A Quarterly	CML
The Classical Journal	CJ
The Classical Quarterly	ClassQ
Claudel Studies	ClaudelS
CLIO: A Journal of Literature, History, and the Philosophy of History	ClioI
Clues: A Journal of Detection	Clues
Co-textes	Co-textes
The Coat of Arms: An Heraldic Quarterly Magazine	CoA
Cognition: International Journal of Cognitive Science	Cognition
Cognitive Linguistics	CogLi
Cognitive Neuropsychology	CogN
Cognitive Psychology	CPsy
Cognitive Science: A Multidisciplinary Journal of Artificial Intelligence, Linguistics, Neuroscience, Philosophy, Psychology	CSci
Colby Quarterly	ClQ
Collection Monographique Rodopi en Littérature Française Contemporaine	CMRLFC
College Composition and Communication	CCC
College English	CE
College Language Association Journal	CLAJ
College Literature	CollL
Colloquia Germanica, Internationale Zeitschrift für Germanische Sprach- und Literaturwissenschaft	CollG
Colloquium Helveticum: Cahiers Suisses de Littérature Comparée/Schweizer Hefte für Allgemeine und Vergleichende Litteraturwissenschaft/Quaderni Svizzeri di Letteratura Generale e Comparata	CHelv
Columbia University Working Papers in Linguistics	CUWPL
Comhar	Comhar
Comitatus: A Journal of Medieval and Renaissance Studies	Comitatus
Commentary	Commentary
Commentationes Humanarum Litterarum Societatis Scientiarum Fennicae	CHLSSF
Commonwealth Essays and Studies	CE&S
Commonwealth Novel in English	CNIE
Commonwealth Quarterly	ComQ
The Commonwealth Review	CoRev
Communication Education	CEd
Communication Monographs	ComM
Communications from the International Brecht Society	CIBS
Communications of the ACM	CACM
The Comparatist: Journal of the Southern Comparative Literature Association	Comparatist
Comparative Civilizations Review	CCRev
Comparative Criticism: A Yearbook	CCrit
Comparative Drama	CompD
Comparative Literature	CL
Comparative Literature Studies	CLS
Computational Linguistics	CompLing
Computers and the Humanities	CHum
Comunità: Rivista di Informazione Culturale	Comunità
The Conch: A Sociological Journal of African Cultures and Literatures	Conch
Conch Review of Books: A Literary Supplement on Africa	CRevB
Conference of College Teachers of English Studies	CCTEP
Confluencia: Revista Hispánica de Cultura y Literatura	Confluencia
Connotations: A Journal for Critical Debate	Connotations
The Conradian	Conradian
Conradiana: A Journal of Joseph Conrad Studies	Conradiana
Constructions	Constructions
Contemporary Approaches to Ibsen	CAtI
Contemporary Literature	ConL
Contemporary Review	ContempR
Continuum: Problems in French Literature from the Late renaissance to the Early Enlightenment	Continuum
Contrastes: Revue de l'Association pour le Développement des Etudes Contrastives	Contrastes
Convorbiri Literare	ConLit
Corona: Making the Edges of Many Circles	Corona
La Corónica: Spanish Medieval Language and Literature Journal and Newsletter	Corónica
Costerus	Costerus
Council on National Literatures/World Report	CNLR
Creative Forum: A Quarterly Journal of Contemporary Writing	CrF
Cristallo: Rassegna di Varia Umanità	Cristallo
Critical Survey	CrSurv
Critical Texts: A Review of Theory and Criticism	CritT
Criticism: A Quarterly for Literature and the Arts	Criticism
Criticón	Criticón
Critique: Studies in Contemporary Fiction	Crit
Cross/Cultures: Readings in the Post/Colonial Literatures in English	CrossC
Cross Currents	Crosscurrents
Crosscurrents/Modern Critiques	CMC
CRUX: A Journal on the Teaching of English	CRUX
CSL: The Bulletin of the New York C. S. Lewis Society	CSLBull
Cuadernos Americanos	CA
Cuadernos de Investigación Filológica	CIF
Cuadernos de Poética	CdP
Cuadernos Hispanoamericanos: Revista Mensual de Cultura Hispanica	CHA
Cultura Neolatina	CN
Cultural Critique	CultCrit
Current Anthropology: A World Journal of the Human Sciences	CAnth
A Current Bibliography on African Affairs	CBAA
Cuyahoga Review	CuyahogaR
The D. H. Lawrence Review	DHLR
Dactylus	Dactylus
Dada/Surrealism	Dada
Dalhousie French Studies	DFS
Dalhousie Review	DR
Dansk Udsyn	Dansk Udsyn
Danske Studier	DS
Dante Studies, with the Annual Report of the Dante Society	DSARDS
Daphnis: Zeitschrift für Mittlere Deutsche Literatur	Daphnis
De Gids	Gids
De Nieuwe Taalgids: Tijdschrift voor Neerlandici	NTg
De Revisor	Revisor
De Vlaamse Gids	VlG
Degré Second: Studies in French Literature	DSec
Degrés: Revue de Synthèse à Orientation Sémiologique	Degrés
Delo: Mesecni Knjizevni Casopis	Delo
Denver Quarterly	DQ
Der Deutschunterricht: Beiträge zu Seiner Praxis und Wissenschaftlichen Grundlegung	DU
Der Islam: Zeitschrift für Geschichte und Kultur des Islamischen Orients	Islam
Der Sprachdienst	Sprachdienst
Deutsch als Fremdsprache: Zeitschrift zur Theorie und Praxis des Deutschunterrichts für Auslaender	DaF
Deutsch-Slawische Forschungen zur Namenkunde und Siedlungsgeschichte	DSFNS
Deutsche Shakespeare-Gesellschaft West: Jahrbuch	DSGW
Deutsche Sprache: Zeitschrift für Theorie, Praxis, Dokumentation	DSp
Deutsche Studien	DSt
Deutsche Vierteljahrsschrift für Literaturwissenschaft und Geistesgeschichte	DVLG
Deutsches Archiv für Erforschung des Mittelalters	DAEM
Developmental Psychology	DP
Devil's Box	DevB
Diachronica: International Journal for Historical Linguistics/Revue Internationale pour la Linguistique Historique/Internationale Zeitschrift für Historische Linguistik	Diachronica
Diacritics: A Review of Contemporary Criticism	Diacritics
Les Dialectes de Wallonie	DdW
Dialog: Miesiecznik Poswiecony Dramaturgii Wspolczesnej: Teatralnej, Filmowej, Radiowej, Telewizyjnej	DialogW
Dialogi: Revija za Kulturo	Dialogi
Dickens Studies Annual: Essays on Victorian Fiction	DSA
The Dickensian	Dickensian
Dickinson Studies: Emily Dickinson (1830-86), U. S. Poet	DicS
Dictionaries: Journal of the Dictionary Society of North America	Dictionaries
Diderot Studies	DidS
Die Horen: Zeitschrift für Literatur, Kunst und Kritik	Horen
Die Neue Gesellschaft/Frankfurter Hefte	FH
Die Neueren Sprache	NS
Die Sprache: Zeitschrift für Sprachwissenschaft	Sprache
Die Unterrichtspraxis	UP
Die Welt der Slaven: Halbjahresschrift für Slavistik	WSl
Die Welt des Islams: Internationale Zeitschrift für die Geschichte des Islams in der Neuzeit	WI
Die Welt des Orients: Wissenschaftliche Beiträge zur Kunde des Morganlandes	WO
Dietsche Warande en Belfort: Tijdschrift voor Letterkunde en Geestesleven	DWB
Differentia: Review of Italian Thought	Differentia
Diliman Review	DilR
Dimension: Contemporary German Arts and Letters	Dimension
Diogenes	Diogenes
Dires: Revue du Centre d'Etudes Freudiennes	Dires
Discours Social/Social Discourse: Analyse du Discours et Sociocritique des Textes/Discourse Analysis and Text Sociocriticism	DS/SD
Discourse: Journal for Theoretical Studies in Media and Culture	Discourse
Discourse Processes: A Multidisciplinary Journal	DPr
Discurso: Revista de Estudios Iberamericanos	Discurso
Dispositio: Revista Americana de Estudios Semióticos y Culturales/American Journal of semiotic and Cultural Studies	Dispositio
Dissertation Abstracts International	DAI
Divus Thomas: Commentarium de Philosophia et Theologia	DT
Dix-Huitième Siècle	DHS
Dix-Septième Siècle	DSS
Dnipro: Literaturno-Khudozhnii ta Hromads'ko-Politychnyi Zhurnal	Dnipro
Documentos A: Genealogia Cientifica de la Cultura	DocumentosA
Dostoevsky Studies: Journal of the International Dostoevsky Society	DStudies
Dreiser Studies	DrSt
Durham Medieval Texts	DMT
Durham University Journal	DUJ
Ear and Hearing: Official Journal of the American Auditory Society	E&H
Early American Literature	EAL
Early Drama, Art, and Music Monograph Series	EDAMMS
Edad de Oro	EdO
Edda: Nordisk Tidsskrift for Litteraturforskning/Scandinavian Journal of Literary Research	Edda
Edith Wharton Review	EWhR
Editors' Notes	EdN
The Edward Sapir Monograph Series in Language, Culture, and Cognition	ESMSLCC
Eighteenth-Century Fiction	ECF
Eighteenth-Century Life	ECLife
Eighteenth-Century Studies	ECS
The Eighteenth Century: Theory and Interpretation	ECent
Eigo Seinen	EigoS
Elementa: Schriften zur Philosophie und ihre Problemgeschichte	Elementa
ELH	ELH
Emakeele Seltsi Aastaraamat	EmSA
Emblematica: An Interdisciplinary Journal of English Studies	Emblematica
Emporia State Research Studies	ESRS
Enclitic	Enclitic
Encomia: Bibliographical Bulletin of the International Courtly Literature Society	Encomia
Encyclia: The Journal of the Utah Academy of Sciences, Arts, and Letters	Encyclia
English Dance and Song	EDS
English in Africa	EinA
The English Journal	EJ
English Language Notes	ELN
English Linguistics: Journal of the English Linguistic Society of Japan	EngLing
English Literary Renaissance	ELR
English Literary Studies Monograph Series	ELS
English Literature and Language	ELLS
English Literature in Transition (1880-1920)	ELT
English Manuscript Studies 1100-1700	EMS
English Record	EngR
English Studies: A Journal of English Language and Literature	ES
English Studies in Africa: A Journal of the Humanities	ESA
English Studies in Canada	ESC
English: The Journal of the English Association	English
English Today: The International Review of the English Language	EnT
English World-Wide: A Journal of Varieties of English	EWW
Envoi: A Review Journal of Medieval Literature	Envoi
Eos.: Commentarii Societatis Philologae Polonorum	Eos.
Epeirotike Hestia	EpH
Epeteris Hetaireias Byzantinon Spoudon	EHBS
Epeteris tou Kentrou Epistemonikon Ereunon Kyprou	EKEEK
Epeteris tou Kentrou Ereunes tes Hellenikes Laographias	EKEHL
Epistemonike Epeterida Philosophikes Scholes Aristoteleiou Panepistemiou Thessalonikes	EEPSAPT
Epitheorese Logou kai Technes	ELkT
Epos: Revista de Filologia	Epos
Equivalences: Revue de l'Institut Supérieur de Traduction et d'Interprètes de Bruxelles	Equivalences
Eranos: Acta Philologica Suecana	Eranos
Escritura: Revista de Teoría y Crítica Literarias	Escritura
Esperanto	Esperanto
Esperienze Letterarie: Revista Trimestrale di Critica e Cultura	ELet
L'Espirit Créateur	ECr
Esprit	Esprit
ESQ: A Journal of the American Renaissance	ESQ
Essays and Studies	E&S
Essays in Arts and Sciences	EAS
Essays in Criticism: A Quarterly Journal of Literary Criticism	EIC
Essays in French Literature	EFL
Essays in Literature	ELWIU
Essays in Theatre/Etudes Théâtrales	EiTET
Essays on Canadian Writing	ECW
Estreno: Cuadernos del Teatro Español Contemporáneo	Estreno
Estudios de Asia y Africa	EOMC
Estudios de Cultura Maya: Publicación Periódica del Centro de Estudios Mayas	ECM
Estudios de Cultura Náhuatl	ECN
Estudios de Lingüística	EdLing
Estudios de Lingüística Aplicada	EDLA
Estudos Anglo-Americanos	EAA
ETC.: A Review of General Semantics	ETC.
Ethnographia: A Magyar Néprajzi Társaság Folyóirata	Ethnographia
Ethnologia Europaea	EthnoE
Ethnologia Scandinavica: A Journal for Nordic Ethnology	EthSc
Ethnologia Slavica	EthS
Ethnologie Française: Revue Trimestrielle de la Société d'Ethnologie Française	EthnoF
Ethnology: An International Journal of Cultural and Social Anthropology	Ethnology
Ethnomusicology: Journal of the Society for Ethnomusicology	Ethnomusicology
Ethology	Ethology
Etudes	Etudes
Etudes Anglaises: Grande-Bretagne, Etats-Unis	EA
Les Etudes Balkaniques Tchécoslovaques	EBT
Les Etudes Classiques	ECl
Etudes Créoles	EtCr
Etudes de Linguistique Appliquée	ELA
Etudes Françaises	EF
Etudes Germaniques	EG
Etudes Germano-Africaines: Revue Annuelle der Germanistique Africaine/Jahresschrift für Afrikanische Germanistik/Annual Review of German Studies in Africa	EGA
Etudes Irlandaises: Revue Française d'Histoire, Civilisation et Littérature de l'Irelande	EI
Etudes Littéraires	ELit
Etudes Philosophiques	EP
Etudes Romanes de Brno	ERBr
The Eugene O'Neill Review	EONR
Euphorion: Zeitschrift für Literaturgeschichte	Euphorion
Europe: Revue Littéraire Mensuelle	Europe
European Journal of Disorders of Communication	EJDC
European Joyce Studies	EJS
European Romantic Review	ERR
European Studies Journal	ESJ
Eutopias: Teorías/Historia/Discurso	Eutopias
Evelyn Waugh Newsletter and Studies	EWNS
Exemplaria: A Journal of Theory in Medieval and Renaissance Studies	Exemplaria
Exeter Linguistic Studies	ELSt
Explicación de Textos Literarios	ExTL
Explicator	Expl
Explorations in Renaissance Culture	EIRC
Extrapolation: A Journal of Science Fiction and Fantasy	Extrapolation
Fachsprache: International Journal of LSP	Fachsprache
Fantasy Commentator	FantCo
Farhang-e Iran Zamin: Revue des Etudes Iranologiques	FIZ
Fataburen: Nordiska Museets och Skansens Årsbok	Fataburen
The Faulkner Journal	FJ
Faulkner Studies	FaulkSt
Faux Titre: Etudes de Langue et Littérature Françaises	FauxT
Feminaria	Feminaria
Feminist Studies	FSt
Field: Contemporary Poetry and Poetics	Field
Film Criticism	FilmC
Film Quarterly	FilmQ
Filología	Filología
Filológiai Közlöny	FK
Finsk Tidskrift	FT
First Language	FirstL
The Flannery O'Connor Bulletin	FCB
Focus on Robert Graves and His Contemporaries	FRG&C
Folia Linguistica: Acta Societatis Linguisticae Europaeae	FoLi
Folia Orientalia	FoliaO
Folia Phoniatrica: International Journal of Phoniatrics, Speech Therapy and Communication Pathology	FPhon
Folk Life: A Journal of Ethnological Studies	FoL
Folk Music Journal	FMJ
Folk og Kultur: Årbog for Dansk Etnologi og Folkemindevidenskab	FoK
Folklife Center News	FCN
Folklore	Folklore
Folklore: English Monthly Devoted to the Cause of Indian Folklore Society	FolkloreC
The Folklore Historian: Journal of the Folklore and History Section of the American Folklore Society	FolkH
Folklore Suisse/Folclore Svizzero: Bulletin de la Société Suisse des Traditions Populaires/Bolletino della Società Svizzera per le Tradizioni Populari	FolkS
Fontane Blätter	FB
Foreign Language Teaching and Research: A Quarterly of Foreign Languages and Cultures	FLTR
Foreign Literatures	FLits
Forschungen zur Geschichte der Älteren Deutschen Literatur	FGADL
Forschungen zur Geschichte Oberösterreiches	FGO
Forum	ForumZ
Forum: A Ukrainian Review	ForumS
Forum der Letteren: Tijdschrift voor Taal- en Letterkunde	FdL
Forum for Modern Language Studies	FMLS
Forum Homosexualität und Literatur	ForumHL
Forum Italicum	FI
Forum Linguisticum (Lake Bluff, Illinois)	ForLing
Foundation: The Review of Science Fiction	Foundation
Foxfire	Foxfire
Francographies: Bulletin de la Société des Professeurs Français et Francophones d'Amérique	Francographies
Frankfurter Beiträge zur Germanistik	FBG
Französisch Heute	FrH
Freiburger Zeitschrift für Philosophie und Theologie	FZPT
French Forum	FrF
French Literature Series	FLS
The French Review: Journal of the American Association of Teachers of French	FR
French Studies: A Quarterly Review	FS
French Studies Bulletin: A Quarterly Supplement	FSB
French Studies in Southern Africa	FSSA
Fróðskaparrit: Annales Societatis Scientiarum Faeroensis	Fróðskaparrit
Frühmittelalterliche Studien: Jahrbuch des Instituts für Frühmittelalterforschung der Universität Münster	FMAS
Fu Jen Studies: Literature & Linguistics	FJS
Gai Saber: Revista de l'Escòla Occitana	GaiS
Gardar: Årsbok för Samfundet Sverige-Island i Lund-Malmö	Gardar
Garland Reference Library of the Humanities	GRLH
Genders	Genders
General Linguistics	GL
Gengo Kenkyu: Journal of the Linguistic Society of Japan	GK
Genre	Genre
George Eliot-George Henry Lewes Studies	GEGHLS
The George Eliot Review: Journal of the George Eliot Fellowship	GER
George Herbert Journal	GHJ
The Georgetown Journal of Languages and Linguistics	GJLL
The Georgia Review	GaR
German-Canadian Yearbook/Deutschkanadisches Jahrbuch	GCY
German Life and Letters	GL&L
The German Quarterly	GQ
German Studies Review	GerSR
Germanic Notes and Reviews	GNR
Germanic Review	GR
Germanisch-Romanische Monatsschrift	GRM
Germanistik: Internationales Referatenorgan mit Bibliographischen Hinweisen	Germanistik
Germanistische Abhandlungen	GA
Germanistische Mitteilungen: Zeitschrift für Deutsche Sprache, Literatur und Kultur in Wissenschaft und Praxis	GMit
The Gettysburg Review	GettR
Gimtoji Kalba	GKa
Giornale Italiano di Filologia	GIF
Giornale Storico della Letteratura Italiana	GSLI
Glotta: Organo de Difusión Lingüística	GlottaC
Glotta: Zeitschrift für Griechische und Lateinische Sprache	Glotta
Glottodidactica: An International Journal of Applied Linguistics	Glottodidactica
Glyph Textual Studies	GlyphT
Gnomon: Kritische Zeitschrift für die Gesamte Klassische Altertumswissenschaft	Gnomon
Godisnjak Centar za Balkanoloska Ispitivanja	GCBI
Goethe-Jahrbuch	Goethe
Goethe Yearbook: Publications of the Goethe Society of North America	GSNA
Gothenburg Studies in English	GothSE
Grand Street	GrandS
Grani: Zhurnal Literatury, Iskusstva, Nauki i Obshchestvenno-Politicheskoi Mysli	Grani
Gratia: Bamberger Schriften zur Renaissanceforschung	Gratia
Grazer Beiträge: Zeitschrift für die Klassische Altertumswissenschaft	GB
Great Plains Quarterly	GPQ
Grial: Revista Galega de Cultura	Grial
Grundtvig-Studier	GStud
Gutenberg-Jahrbuch	GJ
Gymnasium: Zeitschrift für Kultur der Antike und Humanistische Bildung	Gymnasium
Halcyon: A Journal of the Humanities	Halcyon
Hamlet Studies: An International Journal of Research on The Tragedie of Hamlet, Prince of Denmarke	HSt
Harvard Journal of Asiatic Studies	HJAS
Harvard Library Bulletin	HLB
Harvard Studies in Romance Languages	HSRL
Harvard Theological Review	HTR
Harvard Ukrainian Studies	HUS
Hebbel-Janrbuch	HJb
Hebrew Annual Review	HAR
Hebrew Linguistics: A Journal for Hebrew Descriptive, Computational, and Applied Linguistics	HCompL
Hebrew Studies: A Journal Devoted to Hebrew Language and Literature	HebSt
Hebrew University Studies in Literature and the Arts	HUSL
Hefte für Ostasiatische Literatur	HOL
Heidelberger Forschungen	HF
Heine Jahrbuch	HeineJ
Helikon: Irodalomtudányi Szemle	HelikonI
Hellenika	Hellenika
Hellenika: Philologikon, Historikon kai Laographikon Periodikon Syngramma	HellenikaS
The Hemingway Review	HN
The Henry James Review	HJR
Hermes: Zeitschrift für Klassische Philologie	Hermes
High Plains Literary Review	HPLR
Hispamerica: Revista de Literatura	Hispam
Hispania: A Journal Devoted to the Interests of the Teaching of Spanish and Portuguese	Hispania
Hispanic Issues	HispIss
Hispanic Journal	HisJ
Hispanic Review	HR
Hispanófila	Hispano
Historiographia Linguistica: International Journal for the History of the Language Sciences/Revue Internationale pour l'Histoire des Sciences du Langage/Internationale Zeitschrift für die Geschichte der Sprachwissenschaften	HL
Historisk Tidskrift	HT
Historiska och Litteraturhistoriska Studier	HLS
History of European Ideas	HEI
Hitotsubashi Journal of Arts and Sciences	HJA&S
The Hollins Critic	HC
L'Homme: Revue Française d'Anthropologie	Homme
The Hopkins Quarterly	HQ
Horizontes: Revista de la Universidad Católica de Puerto Rico	Horizontes
The Hudson Review	HudR
Human Development	HD
Human Studies: A Journal for Philosophy and the Social Sciences	HumanS
Humanistica Lovaniensia: Journal of Neo-Latin Studies	HumLov
Humanitas: Rivista bimestrale di Cultura	HumB
Humanities in the South: Newsletter of the Southern Humanities Council	HS
Humor: International Journal of Humor Research	Humor
The Hungarian P.E.N./Le P.E.N. Hongrois	HPEN
The Hungarian Quarterly	HungQ
Hungarian Studies in English	HSE
Hungarian Studies Review	HSR
Huntington Library Quarterly: A Journal for the History and Interpretation of English and American Civilization	HLQ
Hymnologiske Meddelelser: Tidsskrift om Salmer	HymnM
IBLA: Revue de l'Institut des Belles Lettres Arabes	IBLA
ICarbS	ICarbS
Il Lettore di Provincia	LdProv
Il Pensiero Politico: Rivista di Storia delle Idee Politiche e Sociali	PPol
Il Portico: Biblioteca di Lettere e Arti	Portico
Il Veltro: Rivista della Civiltà Italiana	Veltro
Il Verri: Rivista di Letteratura	Verri
Ilha do Desterro: A Journal of Language and Literature	IdD
Illinois Historical Journal	JISHS
Incontri Linguistici	InLi
The Independent Shavian	ISh
Index on Censorship	IonC
Indian Horizons	IndH
Indian Journal of Applied Linguistics	IJOAL
Indian Linguistics: Journal of the Linguistic Society of India	IndLing
The Indian Literary Review: A Tri-Quarterly of Indian Literature	ILR
Indian Literature	IndL
The Indian P.E.N.	IPEN
Indo-Iranian Journal	IIJ
Indogermanische Forschungen: Zeitschrift für Indogermanistik und Allgemeine Sprachwissenschaft	IF
Indonesia	Indonesia
Infant Behavior and Development: An International and Interdisciplinary Journal	IBD
L'Information Grammaticale	IG
L'Information Littéraire: Revue Paraissant Cinq Fois par An	IL
Inklings: Jahrbuch für Literatur und Ästhetik	Inklings
Inmun Kwahak: The Journal of Humanities	IKw
Inostrannye Iazyki v Shkole	IJS
Inozemna Filolohiia	InozF
Institute of African Studies, Occasional Publications	IASOP
Insula: Revista de Letras y Ciencias Humanas	Insula
International Fiction Review	IFR
International Folklore Review: Folklore Studies from Overseas	IFRev
International Journal of American Linguistics	IJAL
International Journal of Dravidian Linguistics	IJDL
International Journal of Lexicography	IJLex
International Journal of Middle East Studies	IJMES
International Journal of Slavic Linguistics and Poetics	IJSLP
International Journal of the Sociology of Language	IJSL
International Journal of Translation	IJT
International Review of Applied Linguistics in Language Teaching	IRAL
International Social Science Journal	ISSJ
Internationales Archiv für Sozialgeschichte der Deutschen Literatur	IASL
Interpretation: A Journal of Political Philosophy	IJPP
Inti: Revista de Literatura Hispánica	Inti
Iowa English Bulletin	IEY
The Iowa Review	IowaR
Iqbal Review: Journal of the Iqbal Academy Pakistan	IqR
Iran: Journal of the British Institute of Persian Studies	Iran
Iranian Studies: Journal of the Society for Iranian Studies	IranS
Irish Historical Studies	IHS
Irish University Review: A Journal of Irish Studies	IUR
Irodalomtörténet: History of Literature	Irodalom
Irodalomtörténeti Füzetek	IrodalF
Irodalomtörténeti Közlemények	IK
Issues in Applied Linguistics	IAL
It Beaken: Tydskrift fan de Fryske Akademy	ItB
L'Italia Dialettale: Rivista di Dialettologia Italiana	ID
Italia Francescana	IFr
Italia Medioevale e Umanistica	IMU
Italian Americana	ItalAm
Italian Culture	ItC
Italian Quarterly	IQ
Italian Studies	IS
Italianistica: Rivista di Letteratura Italiana	IRLI
Italica	Italica
Italienisch: Zeitschrift für Italienische Sprache und Literatur	ItalienischZ
Italyan Filolojisi/Filologia Italiana	ItF
ITL: Review of Applied Linguistics	ITL
Izraz: Casopis za Knjizevnu i Umjetnicku Kritiku	Izraz
Izvestiia Akademii Nauk, Seriia Literatury i Iazyka	IAN
Jadavpur Journal of Comparative Literature	JJCL
Jahrbuch der Deutschen Schillergesellschaft	JDSG
Jahrbuch der Jean-Paul-Gesellschaft	JJPG
Jahrbuch der Karl-May-Gesellschaft	JKMG
Jahrbuch der Österreichischen Byzantinistik	JÖBG
Jahrbuch des Freien Deutschen Hochstifts	JFDH
Jahrbuch des Wiener Goethe-Vereins	JWGV
Jahrbuch für Finnisch-Deutsche Literaturbeziehungen: Mitteilungen aus der Deutschen Bibliothek	JFDL
Jahrbuch für Fränkische Landesforschung	JFL
Jahrbuch für Internationale Germanistik	JIG
James Joyce Quarterly	JJQ
Japan Quarterly	JapQ
Jauna Gaita	JGa
Jewish Folklore and Ethnology Review	JFER
Jezik: Casopis za Kulturu Hrvatskoga Knjizevnog Jezika	Jezik
Jezik in Slovstvo	JiS
Jezyk Polski	JPol
JGE: The Journal of General Education	JGE
John Donne Journal: Studies in the Age of Donne	JDJ
Journal Asiatique	JAsiat
Journal des Savants	JS
Journal for the Scientific Study of Religion	JSSR
Journal of Abnormal Psychology	JAP
Journal of Advanced Composition	JAC
Journal of Aesthetics and Art Criticism	JAAC
Journal of American Culture	JACult
Journal of American Folklore	JAF
Journal of American Studies	JAmS
Journal of Anthropological Research	JAR
Journal of Asian Studies	JASt
Journal of Australian Literature	JAusL
Journal of Baltic Studies	JBalS
Journal of Beckett Studies	JBeckS
Journal of Canadian Fiction	JCF
Journal of Canadian Studies/Revue d'Etudes Canadiennes	JCSR
Journal of Caribbean Studies	JCSt
Journal of Child Language	JChL
Journal of Chinese Linguistics	JChinL
Journal of Chinese Philosophy	JChinP
The Journal of Commonwealth Literature	JCL
Journal of Communication	JC
Journal of Communication Inquiry	JOCI
Journal of Comparative Literature and Aesthetics	JCLA
The Journal of Country Music	JCM
Journal of Croatian Studies: Annual Review of the Croatian Academy of America, Inc.	JCS
Journal of Cultural Geography	JCG
Journal of Cuneiform Studies	JCunS
Journal of Documentation	JD
Journal of Dramatic Theory and Criticism	JDTC
Journal of English and Foreign Languages	JEFL
Journal of English and Germanic Philology	JEGP
The Journal of English Language and Literature	JELL
Journal of English Linguistics	JEngL
Journal of English Studies	JEngS
Journal of European Studies	JES
Journal of Experimental Psychology: Human Perception and Performance	JExPH
Journal of Experimental Psychology: Learning, Memory, and Cognition	JExPLMC
Journal of Folklore Research	JFR
Journal of French Language Studies	JFLS
Journal of Hellenic Studies	JoHS
Journal of Hispanic Philology	JHP
Journal of Indian Philosophy	JIP
The Journal of Indian Writing in English	JIWE
Journal of Indo-European Studies	JIES
Journal of Irish Literature	JIL
The Journal of Japanese Studies	JJS
Journal of King Saud University, Arts	JKSUA
Journal of Kyoritsu Women's Junior College	JKWJC
Journal of Language and Social Psychology	JLSP
Journal of Learning Disabilities	JLD
Journal of Linguistics	JL
Journal of Literary Semantics	JLS
Journal of Literary Studies/Tydskrif Vir Literaturwetenskap	JLSTL
Journal of Macrolinguistics	JMacL
Journal of Medieval and Renaissance Studies	JMRS
Journal of Memory and Language	JMemL
The Journal of Modern African Studies	JMAS
Journal of Modern Greek Studies	JMGS
Journal of Modern Literature	JML
Journal of Multilingual and Multicultural Development	JMMD
Journal of Narrative Technique	JNT
Journal of Near Eastern Studies	JNES
Journal of Nervous and Mental Disease	JNMD
Journal of Nonverbal Behavior	JNB
Journal of Northwest Semitic Languages	JNWSL
Journal of Personality and Social Psychology	JPSP
Journal of Philosophical Logic	JPL
Journal of Philosophy	JP
Journal of Phonetics	JPhon
Journal of Popular Culture	JPC
Journal of Popular Film and Television	JPFT
Journal of Pragmatics: An Interdisciplinary Bi-monthly of Language Studies	JPrag
Journal of Ritual Studies	JRStud
Journal of Semantics: An International Journal for the Interdisciplinary Study of the Semantics of Natural Language	JoS
Journal of Semitic Studies	JSS
Journal of South Asian Literature	JSoAL
Journal of Speech and Hearing Research	JSHR
Journal of Tamil Studies	JTamS
Journal of the Acoustical Society of America	JAS
Journal of the American Academy of Religion	JAAR
Journal of the American Oriental Society	JAOS
Journal of the American Romanian Academy of Arts and Sciences	JARAAS
Journal of the Appalachian Studies Association	JASA
Journal of the Asiatic Society of Bombay	JASB
Journal of the Association of Teachers of Japanese	JATJ
Journal of the Chinese Language Teachers Association	JCLTA
Journal of the Cork Historical and Archaeological Society	JCHAS
Journal of the Eighteen Nineties Society	JENS
Journal of the English Institute	JEI
Journal of the Ganganatha Jha Kendriya Sanskrit Vidyapeetha	JGJRI
Journal of the Hellenic Diaspora	JHD
Journal of the History of Ideas	JHI
Journal of the International Phonetic Association	IPAJ
Journal of the Kafka Society of America	JKSA
Journal of the Maharaja Sayajirao University of Baroda	JMSUB
Journal of the Malaysian Branch of the Royal Asiatic Society	JRASM
The Journal of the Midwest Modern Language Association	JMMLA
Journal of the Oriental Institute	JOIB
Journal of the Polynesian Society	JPS
Journal of the Royal Asiatic Society of Great Britain and Ireland	JRAS
Journal of the Royal Society of Antiquaries of Ireland	JRSAI
Journal of the Rutgers University Libraries	JRUL
Journal of the School of Languages	JSL
Journal of the Siam Society	JSSB
Journal of the Southwest	JSw
Journal of the Warburg and Courtauld Institutes	JWCI
The Journal of the William Morris Society	JWMS
Journal of Ukrainian Studies	JUkGS
Journal of West African Languages	JWAL
Journal of West Indian Literature	JWIL
Journalism Quarterly	JQ
Joyce Studies Annual	JSA
Judaism: A Quarterly Journal of Jewish Life and Thought	Judaism
Juznoslovenski Filolog	JF
K&K: Kultur og Klasse. Kritik og Kulturanalyse	K&K
Kalbotyra: Lietuvos TSR Aukstuju Mokyklu Mokslo Darbai	Kalbotyra
Kalevalaseuran Vuosikirja	KSVK
Kanava	Kanava
Kansas Quarterly	KanQ
Kansatieteellinen Arkisto	KAr
Keates-Shelley Journal: Keates, Shelley, Byron, Hunt, and Their Circles	KSJ
Keates-Shelley Review	KSMB
Keel ja Kirjandus (Tallinn, Estonia)	KjK
Keiryo Kokugogaku/Mathematical Linguistics	KeK
Kentucky Folklore Record: A Regional Journal of Folklore and Folklife	KFR
The Kentucky Review	KRev
The Kenyon Review	KR
Kerkyraika Chronika	KerC
The Kipling Journal	KJ
Kirjallisuudentutkijain Seuran Vuosikirja	KSV
Kiswahili	Kiswahili
Klage: Kölner Linguistiche Arbeiten-Germanistik	Klage
Klasgids: By die Studie van die Afrikaanse Taal en Letterkunde	Klasgids
Klaus-Groth-Gesellschaft Jahresgabe	KGGJ
Kleine Beiträge zur Droste-Forschung (Münster, FRG)	KBDF
Knjizevna Istorija	KnjIst
Knjizevna Kritika: Casopis za Estetiku Knjizevnosti	KnjiK
Knjizevnost	Knji
Knygotyra: Vilniaus Universiteto Mokslo Darbai	Knygotyra
Kodikas/Code/Ars semeiotica	Kodikas
Kongelige Danske Videnskabernes Selskab. Historisk-Filosofiske Meddelelser	KDVS
Kontekst: Literary Theory Studies	Kontekst
Korea Journal	KoJ
Korespondence Pomembnih Slovencev	KPS
Korrespondenzblatt des Vereins für Niederdeutsche Sprachforschung	KVNS
Kortárs: Irodalmi és Kritikai Folyóirat	Kortárs
Korunk	Korunk
Kritik: Tidsskrift for Litteratur, Forskning, Undervisning	Kritik
Kul'tura Slova	KSl
Kultura: Szkice, Opowiadania, Sprawozdania	KulturaP
Kulturos Barai	KB
Kulturtidskriften HORISONT	Horisont
Kunapipi	Kunapipi
Kwansei Gakuin University Annual Studies	KGUAS
Kwartalnik Neofilologiczny	KN
Kypriakai Spoudai	KyS
Kypriakos Logos	KL
Lamar Journal of the Humanities	LJHum
Landfall: A New Zealand Quarterly	Landfall
Le Langage et l'Homme: Recherches Pluridisciplinaires sur le Langage	Lang&H
Langages	Langages
Language and Computers: Studies in Practical Linguistics	L&Comp
Language and Culture	Lang&C
Language and Literature: Journal of the Poetics and Linguistics Association	Lang&Lit
Language and Speech	L&S
Language and Style: An International Journal	Lang&S
Language in Society (Boulder, CO)	LSoc
Language: Journal of the Linguistic Society of America	Language
Language Learning: A Journal of Applied Linguistics	LL
Language Problems and Language Planning/Lingvaj Problemoj kaj Lingvo-Planado	LPLP
The Language Quarterly	LangQ
Language Research	LangR
Language Sciences	LangS
Language Testing	LangT	
Language Variation and Change	LV&C
Langue Française	LFr
Les Langues Modernes	LanM
Les Langues Néo-Latines: Bulletin Trimestriel de la Société de Langues Néo-Latines	LLNL
Latin Amerian Music Review/Revista de Música Latinoamericana	LAMR
Latin American Indian Literatures Journal: A Review of American Indian Texts and Studies	LAILJ
Latin American Literary Review	LALR
Latin American Theatre Review	LATR
Latinitas: Commentarii Linguae Latinae Excolendae	Latinitas
Latomus: Revue d'Etudes Latines	Latomus
Latvijas Zinatnu Akademijas Vestis	LZAV
Lebende Sprachen: Zeitschrift für Fremde Sprachen in Wissenschaft und Praxis	LSp
Lectura Dantis: A Forum for Dante Research and Interpretation	LDant
Legacy: A Journal of American Women Writers	Legacy
Legon Journal of the Humanities	LJH
Lendemains: Etudes Comparées sur la France/Vergleichende Frankreichforschung	Lendemains
Lenguaje y Texto	LyT
Lenguas Modernas	LengM
Leshonenu La'Am	LLa
Leshonenu/Lesonénu: A Journal for the Study of the Hebrew Language and Cognate Subjects/Ketav-'Et le-Heqer ha-Lashon ha-'Ivrit ve-ha-Tehumim ha-Semukhim Lah	Leshonenu
Lessing Yearbook/Jahrbuch	LY
Letras de Buenos Aires	LdBA
Letras Femeninas	LFem
Letras Peninsulares	LetP
Letterato: Periodico di Attualità e Cultura	Letterato
Letteratura Italiana Contemporaneo: Rivista Quadrimestrale di Studi Sul Novecento	LIC
Letterature d'America: Rivista Trimestrale	LAmer
Lettere Italiane	LI
Lettres Québécoises	LQ
Les Lettres Romanes	LR
Letture Classensi	LetC
Letture: Libro e Spettacolo/Mensile di Studi e Rassegne	Letture
Leuvense Bijdragen: Contributions in Linguistics and Philology	LB
Leyte-Samar Studies	LSS
Liberté	Liberté
Libraries & Culture: A Journal of Library History	Lib&C
Librarium: Zeitschrift der Schweizerischen Bibliophilen-Gesellschaft/Revue de la Société Suisse des Bibliophiles	Librarium
The Library: The Transactions of the Bibliographical Society	Library
Libri: International Library Review	Libri
La Licorne	Licorne
LiLi: Zeitschrift für Literaturwissenschaft und Linguistik	LiLi
Limba Romana	LimR
Lingua e Stile: Trimestrale di Filosofia del Linguaggio, Linguistica e Analisi Letteraria	LeS
Lingua: International Review of General Linguistics	Lingua
Lingua Nostra	LN
The Linguist	Linguist
Linguistic Analysis	LingA
Linguistic Inquiry	LingI
The Linguistic Review	TLR
Linguistica	Linguistica
Linguistica Antverpiensia	LA
Linguistica Biblica: Interdisziplinäre Zeitschrift für Theologie und Linguistik	LBib
Linguistica Uralica	LUral
Linguistics: An Interdisciplinary Journal of the Language Sciences	Linguistics
Linguistics and Education: An International Research Journal	L&E
Linguistics and Philosophy: An International Journal	Ling&P
La Linguistique: Revue de la Société Internationale de Linguistique Fonctionnelle/Journal of the International Society of Functional Linguistics	Linguistique
Linguistische Berichte	LingB
Lingvisticæ Investigationes: Revue Internationale de Linguistique Française et de Linguistique Générale	LingInv
The Lion and the Unicorn: A Critical Journal of Children's Literature	L&U
Listy Filologické: Folia Philologica	LF
Lit: Literature Interpretation Theory	LIT
Literarni Leksikon	LitLeks
Literary and Linguistic Computing: Journal of the Association for Literary and Linguistic Computing	L&LC
The Literary Criterion	LCrit
The Literary Endeavour: A Quarterly Journal Devoted to English Studies	LitE
Literary Half-Yearly	LHY
The Literary Review: An International Journal of Contemporary Writing	LitR
Literatur für Leser	LfL
Literatur in Wissenschaft und Unterricht	LWU
Literatur und Kritik	LuK
Literatura (Budapest, Hungary)	Literatura
Literatura Chilena: Creación y Crítica	LitC
Literatura Foiro: Kultura Revuo en Esperanto	LFoiro
Literatura ir Menas	LiMen
Literatura: Lietuvos Aukstuju Mokyklu Mokslo Darbai (Vilnius, Lithuania} {Literatura}	Literatura: Lietuvos Aukstuju Mokyklu Mokslo Darbai (Vilnius, Lithuania} {Literatura}
Literatura Ludowa	LLud
Literatura un Maksla	LuM
Literature and Belief	L&B
Literature and History	L&H
Literature and Medicine	L&M
Literature and Psychology	L&P
Literature East and West	LE&W
Literature/Film Quarterly	LFQ
Literature & Theology: An Interdisciplinary Journal of Theory and Criticism	L&T
Literaturen Forum: Sedmichnik na Nesavisimite Balgarski Pisateli	LForum
Literaturna Misul	LMi
Literaturnaia Gazeta	LG
Literaturnoe Obozrenie: Organ Soiuza Pisatelei SSSR	LO
Literaturwissenschaftliches Jahrbuch im Auftrage der Görres-Gesellschaft	LJGG
Litterae Slovenicae: A Slovene Literary Magazine	LittSlov
Litteraria: Teoria Literatury. Metodologia. Kultura. Humanistyka	Litteraria
Littérature	Lit
Littératures	Litt
Lituanus: Baltic States Quarterly of Arts & Sciences	Lituanus
Living Author Series	LAS
Living Blues: A Journal of the African-American Blues Tradition	LBl
Lletra de Canvi	LdC
London Review of Books	LRB
[London] Times Literary Supplement	TLS
Looming: Eesti Kirjanike Liidu Kuukiri	LoomingE
Lore and Language	Lore&L
Los Ensayistas: Georgia Series on Hispanic Thought	Ensayistas
Lost Generation Journal	LGJ
Lovecraft Studies	LSt
Lucero: A Journal of Iberian and Latin American Studies	Lucero
Lud: Organ Polskiego Towarzystwa Ludoznawczego i Komitetu Nauk Etnologicznych Polskiej Akademii/Organe de la Société Polonaise d'Ethnologie et du Comité des Sciences Ethnologiques	Lud
Luso-Brazilian Review	LBR
Luther: Zeitschrift der Luther-Gesellschaft	Luther
Lutherjahrbuch	LJb
Maal og Minne	MM
Maatstaf	Maatstaf
Macedonian Review: History, Culture, Literature, Arts	MacR
Machine Translation	MachT
Magazine Littéraire	MagLitt
Magyar Könyvszemle: Könyvtörténeti Folyóirat/Revue pour l'Histoire du Livre et de la Presse	MK
Magyar Nyelv	MNy
Magyar Nyelvjárások	MNyj
Magyar Nyelvõr	MagN
Maia: Rivista di Letterature Classiche	Maia
Majalle(h)-ye Daneshkad(h)-ye Adabiyyat-e va Olume-e Ensani-e Danashga(h)-e Ferdowsi	MDAM
Makedonika	Makedonika
Makedonski Jazik	MJ
Maledicta: The International Journal of Verbal Aggression	Maledicta
Mallorn: The Journal of the Tolkein Society	Mallorn
Mana	Mana
The Mankind Quarterly	ManQ
Manscriptum: Revista Trimestriala Editata de Muzeul Literaturii Române	Manscriptum
Manuscripta	Manuscripta
Manuscripts	MSS
Marbacher Magazin	MarM
Marianum	Marianum
Mark Twain Journal	MTJ
Maske und Kothurn: Internationale Beiträge zur Theaterwissenschaft	MuK
Massachusetts Review: A Quarterly of Literature, the Arts and Public Affairs	MR
Matatu: Journal for African Culture and Society	Matatu
Material Culture: Journal of the Pioneer American Society	MCul
Mawazo: The Makerere Journal of the Faculties of Arts and Social Sciences	Mawazo
Meanjin	Meanjin
Mededelingen der Koninklijke Nederlandse Akademie van Wetenschappen, Afdeling Letterkunde, Nieuwe Reeks	MKNAL
Mededelingen van de Nijmeegse Centrale voor Dialect- en Naamkunde	MNCDN
Mediaeval Scandinavia	MScan
Mediaeval Studies	MS
Mediaevalia: A Journal of Mediaeval Studies	Mediaevalia
Medieval & Renaissance Drama in England: An Annual Gathering of Research, Criticism and Reviews	MRDE
Medieval & Renaissance Texts & Studies	MRTS
Medievalia et Humanistica: Studies in Medieval and Renaissance Culture	M&H
Medium Ævum	MÆ
Memoirs of the Research Department of the Toyo Bunko	MRD
Memory & Cognition	M&C
Menckeniana: A Quarterly Review	Menckeniana
Merkur: Deutsche Zeitschrift für europäisches Denken	Merkur
Mester	Mester
Meta: Journal des Traducteurs/Translators' Journal	Meta
Metmenys	Metmenys
Michigan Academician	MichA
Michigan Quarterly Review	MQR
Mid-American Review	MARev
Midamerica: The Yearbook of the Society for the Study of Midwestern Literature	Midamerica
Midwest Quarterly: A Journal of Contemporary Thought	MQ
Midwestern Miscellany	MMisc
Milton Quarterly	MiltonQ
Milton Studies	MiltonS
Minas Gerais, Suplemento Literário	MGSL
Mind: A Quarterly Review of Philosophy	Mind
The Minnesota Review	MinnR
Minos: Revista de Filologia Egea	Minos
Miscellanea Mediaevalia	MiscMed
Mississippi Quarterly: The Journal of Southern Culture	MissQ
Missouri Folklore Society Journal	MFSJ
The Missouri Review	MissR
Mitteilungen der Deutschen Orient-Gesellschaft zu Berlin	MDOG
Mitteilungen der E.T.A. Hoffmann-Gesellschaft-Bamberg e.V.	MHG
Mitteilungen des Verbandes deutscher Anglisten	MVdA
Mitteilungen und Forschungsbeiträge der Cusanus-Gesellschaft	MFCG
Mittellateinisches Jahrbuch: Internationale Zeitschrift für Mediävistik/International Journal of Medieval Studies/Revue Internationale des Etudes Médiévales/Rivista Internazionale di Studi Medievali	MitJ
Mladika	Mladika
MLN	MLN
Mnemosyne: Bibliotheca Classica Batava	Mnemosyne
Mnemosyne: Etesion Periodikon tes Hetaireias Historikon Spoudon epi tou Neoterou Hellenismou	MnemosyneA
Modern Age: A Quarterly Review	ModA
Modern Austrian Literature	MAL
Modern Chinese Literature	MCL
Modern Drama	MD
Modern Fiction Studies	MFS
Modern Hebrew Literature	MHL
Modern Humanities Research Association Texts and Dissertations Series	MHRADS
The Modern Language Journal	MLJ
Modern Language Quarterly	MLQ
The Modern Language Review	MLR
Modern Language Studies	MLS
Modern Phililogy: A Journal Devoted to Research in Medieval and Modern Literature	MP
Moderna Språk (Stockholm)	MSpr
Mogucnosti: Knjizevnost, Umjetnost, Kulturni Problemi	Mogucnosti
Monatshefte: für Deutschen Unterricht, Deutsche Sprache und Literatur	Monatshefte
Monographs in International Studies, Africa Series. Ohio University Center for International Studies	MSAS
Monographs in International Studies, Southeast Asia Series. Ohio University Center for International Studies	PSSEAS
Monographs in Modern Languages	MML
Monumenta Nipponica	MN
Moreana: Bulletin Thomas More	Moreana
Mosaic: A Journal for the Interdisciplinary Study of Literature	Mosaic
Mostovi	Mostovi
Mount Olive Review	MOR
Movoznavstvo: Naukovo-Teoretychnyi Zhurnal Viddilennia Literatury, Movy i Mystetstvoznavstva Akademii Nauk Ukraine	Mov
Le Moyen Âge: Revue d'Histoire et de Philologie	MA
Moznayim: Yarhon Agudat ha-Soferim ha-'Ivrim be-Medinat Yisrael/Monthly of the Association of Hebrew Writers in Israel	Moznayim
Münchener Beiträge zur Mediävistik u. Renaissance-Forschung	MBMRF
Münchener Studien zur Sprachwissenschaft	MSzS
Münchener Texte und Untersuchungen zur Deutschen Literatur des Mittelalters	MTUDLM
Naamkunde	Nku
Names: Journal of the American Name Society	Names
Narodna Tvorchist' ta Etnohrafiia	NTE
Narodna Umjetnost	NUm
Narodno Stvaralastvo. Folklor	NStv
Nas Jezik	NJe
Nase Rec	NRec
Nash Sovremennik: Literaturno-Khudozhestvennyi i Obshchestvenno-Politicheskii Zhurnal	NSov
Nashriyye(h)-ye Daneshkade(h)-ye Adabiyyat va Olum-e Ensani-ye Tabriz	NDAT
The Nassau Review: The Journal of Nassau Community College Devoted to Arts, Letters, and Sciences	NR
The Nathaniel Hawthorne Review	NHR
Nationalities Papers	NatP
Natural Language & Linguistic Theory	NL&LT
Naucni Sastanak Slavista u Vukove Dane	NSSVD
Nea Poreia	NP
Negative Capability	NegCap
Neohelicon: Acta Comparationis Litterarum Universarum	Neohelicon
Neophililogus	Neophil
Neue Rundschau	NRs
Neue Sammlung: Vierteljahres-Zeitschrift für Erziehung und Gesellschaft	NSammlung
Neuphilologische Mitteilungen: Bulletin de la Société Néophilologique/Bulletin of the Modern Language Society	NM
Neusprachliche Mitteilungen aus Wissenschaft und Praxis	NsM
Neva	Neva
The New Criterion	NewC
The New England Quarterly: A Historical Review of New England Life and Letters	NEQ
New England Review	NERMS
New England Theatre Journal	NETJ
New German Critique: An Interdisciplinary Journal of German Studies	NGC
New Letters	NewL
New Literary History: A Journal of Theory and Interpretation	NLH
New Mexico Humanities Review	NMHR
New Orleans Review	NOR
New Quest	Quest
New Scholar: An Americanist Review	NewS
New Theatre Quarterly	NTQ
The New Welsh Review	NWRev
The New York Review of Books	NYRB
The Newberry Library Center for the History of the American Indian Bibliographical Series	NLCHAIBS
Newsletter of the American Dialect Society	NADS
Niederdeutsched Wort: Beiträge zur Niederdeutschen Philologie	NdW
Niederdeutsches Jahrbuch: Jahrbuch des Vereins für Niederdeutsche Sprachforschung	NJ
Nietzsche Studien: Internationales Jahrbuch für die Nietzsche-Forschung	NietzscheS
Nineteenth-Century Contexts	NCC
Nineteenth-Century French Studies	NCFS
Nineteenth-Century Literature	NCF
Nineteenth-Century Prose	NCP
Nineteenth Century Theatre	NCTR
Nord Nytt: Nordisk Tidsskrift for Folkelivsforskning	NNy
Nordelbingen: Beiträge zur Kunst- und Kulturgeschichte	Nordelbingen
Nordfriesisches Jahrbuch	NFJ
Nordic Journal of Linguistics	NJL
Nordlyd: Tromsø University Working Papers on Language & Linguistics	Nordlyd
Norsk Lítterær Årbok	NLÅ
Norte: Revista Hispano-Americana	Norte
North Carolina Folklore Journal	NCarF
North Carolina Historical Review	NCHR
North Carolina Studies in Romance Languages and Literatures	UNCSRLL
North Dakota Quarterly	NDQ
North-Holland Linguistic Series	NHLS
Northeast Folklore	NoEF
Northwest Ohio Quarterly	NOQ
Northwest Review	NWR
Norwegian-American Studies	NAS
Notes and Queries	N&Q
Notes on Linguistics	NLing
Notes on Translation	NOT
Notre Librairie: Revue du Livre: Afrique, Caraïbes, Océan Indien	NLib
Nottingham French Studies	NFS
Nottingham Medieval Studies	NMS
Nouvelle Revue Française	NRF
Novel: A Forum on Fiction	Novel
Novyi Zhurnal/The New Review	NovZ
Now and Then	N&T
Nowi Dni	Nowi Dni
Nueva Revisita de Filología Hispánica	NRFH
Nuovi Argomenti	NArg
Nyelvtudományi Közlemények	NK
Objects et Mondes: La Revue du Musée de l'Homme	OM
Obsidian II: Black Literature in Review	Obsidian II
Occasional Papers on Linguistics	OPLing
Oceania	Oceania
Oceanic Linguistics Special Publications	OLSP
October	October
Odra	Odra
Odù: A Journal of West African Studies	Odù
Oeuvres & Critiques: Revue Internationale d'Etude de la Réception Critique d'Etude des Oeuvres Littéraires de Langue Française	O&C
Ogam: Tradition Celtique	Ogam
The Ohio Review	OhR
Okike: An African Journal of New Writing	Okike
Oklahoma Project for Discourse and Theory	OPDT
Oktiabr': Literaturno-Khudozhestvennyi i Obshchestvenno-Politicheskii Zhurnal	Okt
Old English Newsletter	OENews
The Old Northwest: A Journal of Regional Life and Letters	ON
Olifant: A Publication of the Société Rencesvals, American-Canadian Branch	Olifant
Onoma: Bibliographical and Information Bulletin	Onoma
Onomastica: Pismo Poswiecone Nazewnictwu Geograficznemu i Osobowemu	Onomastica
Ons Erfdeel: Algemeen-Nederlands Tweemaandelijks Cultureel Tijdschrift	OnsE
Ons Geestelijk Erf: Driemaandelijks Tijdschrift voor de Geschiedenis van de Vroomheid in de Nederlanden	OGE
Onsei Gakkai Kaihô [Bulletin of the Phonetic Society of Japan]	OGK
Ontario Review	OntarioR
The Oral History Review: Journal of the Oral History Association	OralHR
Oral History: The Journal of the Oral History Society	OralH
Oral Tradition	OT
Orbis Litterarum: International Review of Literary Studies	OL
Ord och Bild	OB
Orientalia Suecana	OS
Orizont: Revista a Uniunii Scriitorilor din Republica Socialista România	Orizont
Ortnamnssällskapets i Uppsala Årsskrift	OUÅ
Osmayor: Graduate Student Review	Osmayor
Overland	Overland
Oxford German Studies	OGS
The Oxford Literary Review	OLR
Oxford Slavonic Papers	OSP
Pacific Coast Philology	PCP
Paideia (Buffalo, New York)	PaideiaFS
Paideia: Rivista Letteraria di Informazione Bibliografica	Paideia
Paideuma: A Journal Devoted to Ezra Pound Scholarship	Paideuma
Paintbrush: A Journal of Poetry, Translations, and Letters	Paintbrush
La Palabra y el Hombre: Revista de la Universidad Veracruzana	PH
Palimpsest	Palimpsest
Pamietnik Literacki: Czasopismo Kwartalne Poswiecone Historii i Krytyce Literatury Polskiej	PL
Pamietnik Slowianski	PaSlow
Pamietnik Teatralny: Kwartalnik Poswiecony Historii I Krytyce Teatru	PaT
Panjab University Research Bulletin (Arts)	PURBA
Papers and Studies in Contrastive Linguistics	PSCL
Papers of the Bibliographical Society of America	PBSA
Papers of the Bibliographical Society of Canada/Cahiers de la Société Bibliographique du Canada	PBSC
Papers on French Seventeenth Century Literature	PFSCL
Papers on Language and Literature: A Journal for Scholars and Critics of Language and Literature	PLL
Papiere zur Textlinguistik/Papers in Textlinguistics	PText
Parabola: The Magazine of Myth and Tradition	Parabola
Parnasso	Parnasso
Parnassos: Philologikon Periodikon/Literary Journal of the Parnassos Literary Society	ParnassosL
Parnassus: Poetry in Review	Parnassus
Partisan Review	PR
PASAA: The Journal of Language Teaching and Learning in Thailand	PASAA
Patma-Banasirakan Handes: Istoriko-Filologiceskii Zhurnal	PBH
Pennsylvania Folklife	PF
Pennsylvania Magazine of History and Biography	PMHB
La Pensée: Revue du Rationalisme Moderne	Pensée
Pequod: A Journal of Contemporary Literature and Literary Criticism	Pequod
Perception & Psychophysics	P&P
Perceptual and Motor Skills	PMS
Performing Arts Journal	PArtsJ
Performing Arts Resources	PAR
Peritia: Journal of the Medieval Academy of Ireland	Peritia
Personhistorisk Tidskrift	PHT
Persuasions: Journal of the Jane Austen Society of North America	Persuasions
Philippine Sociological Review	PhSR
Philippine Studies	PSM
Philobiblon: Eine Vierteljahrsschrift für Buch- und Graphiksammler	Philobiblon
Philological Quarterly	PQ
Philologike Kypros	PK
Philologus: Zeitschrift für Klassische Philologie	PZKA
The Philosophical Quarterly	PhQ
Philosophical Review	PhR
Philosophical Studies: An International Journal for Philosophy in the Analytic Tradition	PhS
Philosophisches Jahrbuch der Görres-Gesellschaft (Friberg, FRG)	PJGG
Philosophy and Literature	P&L
Philosophy and Phenomenological Research	PPR
Philosophy and Rhetoric	P&R
Philosophy East and West: A Quarterly of Comparative Philosophy	PE&W
Phoenix	PhoenixK
Phoenix: The Journal of the Classical Association of Canada/Revue de la Société Canadienne des Etudes Classiques	PhoenixC
Phonetica: International Journal of Speech Science	Phonetica
Phylon: A Review of Race and Culture	Phylon
Ploughshares	Ploughshares
Plural: Revista Cultural de Excelsior	Plural
PMLA: Publications of the Modern Language Association of America	PMLA
PN Review	PNR
Pneumatike Kypros	PKy
Po&sie	Po&sie
Poe Studies: Dark Romanticism: History, Theory, Interpretation	PoeS
Poetica: Zeitschrift für Sprach- und Literaturwissenschaft	Poetica
Poetics: Journal for Empirical Research on Literature, the Media and the Arts	PoeticsJ
Poetics Today	PoT
Post Script: Essays in Film and the Humanities	PostS
Postmodern Culture: An Electronic Journal of Interdisciplinary Criticism	PMC
Postmodern Studies	PmdnS
The Powys Review	PRev
Prace Jezykoznawcze	PANPJ
Prace Komisji Jezykoznawstwa	PKJ
Prace Komisji Slowianoznawstwa	PANPKS
Pragmatics: Quarterly Publication of the International Pragmatics Association	Pragmatics
Prague Bulletin of Mathematical Linguistics	PBML
Prapor: Literaturno-Khudozhnii ta Hromads'ko-Politychnyi Zhurnal	Prapor
Pre/Text: A Journal of Rhetorical Theory	Pre/Text
Proceedings of the Leeds Philosophical and Literary Society, Literary & Historical Section	PLPLS-LHS
Proceedings of the Massachusetts Historical Society	PMHS
Proceedings & Transactions Royal Society of Canada	PTRSC
Profession	Profession
Promeny	Promeny
Prooftexts: A Journal of Jewish Literary History	Prooftexts
Prose Studies: History, Theory, Criticism	PSt
Prospects: An Annual Journal of American Cultural Studies	Prospects
Psychiatry: Interpersonal and Biological Processes	Psychiatry
Psychological Bulletin	PsyB
Psychological Review	PsychologR
Public Culture: Bulletin of the Society for Transnational Cultural Studies	PubCult
Publication of the American Dialect Society	PADS
Publications of the Mississippi Philological Association	POMPA
Publications of the Philogical Society	PPS
Publications of the Texas Folklore Society	PTFS
Publications Romanes et Françaises	PRF
Publishing History: The Social, Economic and Literary History of Book, Newspaper and Magazine Publishing	PubHist
Publishing Research Quarterly	PRQ
Quaderni d'Italianistica: Official Journal of the Canadian Society for Italian Studies	QI
Quaderni del Dipartimento di Lingue e Letterature Straniere Moderne, Universita di Genova	QDLLSM
Quaderni di Filologia Germanica della Facoltà di Lettere e Filosofia dell'Università di Bologna	QFG
Quaderni Ibero-Americani: Attualità Culturale della Penisola Iberica e America Latina	QIA
Quaderni Veneti	QVen
Quadrant (Australia)	Quadrant (Australia)
Quantitative Linguistics	QLing
The Quarterly Journal of Speech	QJS
Quarterly Review of Film and Video	QRFV
Queen's Quarterly	QQ
Queensland Studies in German Language and Literature	QSGLL
Quellen und Forschungen zur Sprach- und Kulturgeschichte der Germanischen Völker	QFSK
Qui Parle: A Journal of Literary and Critical Studies	QPar
Quimera: Revista de Literatura	Quimera
La Quinzaine Littéraire	QL
Quondam et Futurus: A Journal of Arthurian Interpretation	Q&F
Raduga	Raduga
Rajasthan University Studies in English	RUSEng
Rare Books & Manuscripts Librarianship	RBML
Raritan: A Quarterly Review	Raritan
Rassegna della Letteratura Italiana	RLI
Rassegna Italiana di Linguistica Applicata	RILA
Rassegna Storica del Risorgimento	RSR
Razgledi: Spisanie za Literatura Umetnost i Kultura	Razgledi
Razón y Fe: Revista Hispanoamericana de Cultura	RyF
RE Arts & Letters: A Liberal Arts Forum	REAL
Reading and Writing: An Interdisciplinary Journal	R&W
Reading Psychology: An International Quarterly	RPsych
Reading Research Quarterly	RRQ
Recherches Anglaises et Nord-Américaines	RANNAM
Recherches de Science Religieuse	RechSR
Recherches Germaniques	RGer
Recherches sur Diderot et sur l'Encyclopédie	RDidE
Recherches sur le Français Parlé	RFP
Records of Early English Drama Newsletter	REEDN
Regensburger Beiträge zur Deutschen Sprach- und Literaturwissenschaft. Reihe B: Untersuchungen	RBSL
Regional Language Studies-Newfoundland	RLS
Reihe Siegen: Beiträge zur Literatur-, Sprach- und Medienwissenschaft	RSieg
Reinardus: Yearbook of the International Reynard Society/Annuaire de la Société Internationale Renardienne	Reinardus
RELC Journal: A Journal of Language Teaching and Research in Southeast Asia	RELC
Religion and Literature	R&L
Renaissance and Reformation/Renaissance et Réforme	Ren&R
The Renaissance Bulletin	RenB
Renaissance Drama	RenD
Renaissance & Modern Studies	RMS
Renaissance Monographs	RenM
Renaissance Papers	RenP
Renaissance Quarterly	RenQ
Renaissance Studies: Journal of the Society for Renaissance Studies	RenSt
Renascence: Essays on Value in Literature	Renascence
Rendiconti dell'Istituto Lombardo Accademia di Scienze e Lettere	RIL
Renditions: A Chinese-English Translation Magazine	Renditions
Representations	Representations
República de las Letras	RLetras
Research in African Literatures	RAL
Research Opportunities in Renaissance Drama	RORD
Resources for American Literary Study	RALS
Restant: Tijdschrift voor Recente Semiotische Teorievorming en de Analyse van Teksten/Review for Semiotic Theories and the Analysis of Texts	Restant
Restoration and 18th Century Theatre Research	RECTR
Restoration: Studies in English Literary Culture, 1660-1700	Restoration: Studies in English Literary Culture, 1660-1700
Review	Rev
Review: Latin American Literature and Arts	Review
The Review of Contemporary Fiction	RCF
Review of English Studies: A Quarterly Journal of English Literature and the English Language	RES
Review of National Literatures	RNL
Revista Canadiense de Estudios Hispánicos	RCEH
Revista Canaria de Estudios Ingleses	RCEI
Revista de Critica Literaria Latinoamericana	RCLL
Revista de Dialectología y Tradiciones Populares	RDTP
Revista de Estudios Hispánicos (Río Piedras, Puerto Rico)	REH-PR
Revista de Estudios Hispánicos (St. Louis, MO)	REH
Revista de História	RdH
Revista de Istorie si Teorie Literara	RITL
Revista de Occidente	RO
Revista Española de Lingüística	REspL
Revista Hispánica Moderna	RHM
Revista Iberoamericana	RI
Revista Interamericana de Bibliografia/Inter-American Review of Bibliography	RIB
Revista Letras	RLet
Revista Portuguesa de Filologia	RPF
Revista Portuguesa de Filosofia	RPFilos
Revista/Review Interamericana	RevI
Revista Signos: Estudios de Lengua y Literatura	RSV
Revue Bazmavep: Hayagitakan-Banasirakan-Grakan Handes/Revue d'Etudes Arméniennes	Bazmavep
Revue Belge de Philologie et d'Histoire/Belgisch Tijdschrift voor Filologie en Geschiedenis	RBPH
Revue Bénédictine	RB
Revue d'Histoire du Théâtre	RHT
Revue d'Histoire Ecclésiastique	RHE
Revue d'Histoire Littéraire de la Françe	RHL
Revue de l'ACLA/Journal of the CAAL	RACLA
Revue de l'Université d'Ottawa/University of Ottawa Quarterly	RUO
Revue de Littérature Comparée	RLC
Revue de Métaphysique et de Morale	RMM
Revue de Philologie de Littérature et d'Histoire Anciennes	RPLHA
Revue de Phonétique Appliquée	RevPL
Revue des Etudes Anciennes	REAnc
Revue des Etudes Arméniennes	REArmNS
Revue des Etudes Grecques	REG
Revue des Etudes Islamiques	REIsl
Revue des Etudes Italiennes	REI
Revue des Etudes Latines	RELat
Revue des Langues Romanes	RLR
La Revue des Lettres Modernes: Histoire des Idées et des Littératures	RLM
Revue des Sciences Humaines	RSH
Revue Francophone de Louisiane	RFdL
Revue Générale	RG
Revue Québécoise de Linguistique	RQdL
Revue Québécoise de Linguistique Théorique et Appliquée	RAQL
Revue Romane	RevR
Revue Roumaine de Linguistique	RRL
Revue Thomiste: Revue Doctrinale de Théologie et de Philosophie	RThom
Rheinische Vierteljahrsblätter	RhV
Rheinisches Jahrbuch für Volkskunde	RJV
Rheinisches Museum für Philologie	RMP
Rhetoric Review	RhetRev
Rhetoric Society Quarterly	RSQ
Rhetorica: A Journal of the History of Rhetoric	Rhetorica
Rinascimento: Rivista dell'Istituto Nazionale di Studi sul Rinascimento	Rinascimento
Riverside Quarterly	RQ
La Rivista Dalmatics	RD
Rivista degli Studi Orientali	RdSO
Rivista di Cultura Classica e Medievale	RCCM	
Rivista di Estetica	RdE
Rivista di Filosofia Neo-Scolastica	RFNS
Rivista di Letterature Moderne e Comparate	RLMC
Rivista di Linguistica	RdLing
Rivista di Storia e Letteratura Religiosa	RSLR
Rivista di Studi Bizantini e Neoellenici	RSBN
Rivista di Studi Italiana	RSItal
Rivista Italiana di Dialettologia: Lingue Dialetti Società	RID
Rivista Storica Italiana	RSI
RLA: Revista de Lingüística Teórica y Aplicada	RLTA
Rocky Mountain Review of Language and Literature	RMR
Rocznik Komisji Historycznoliterackiej	RKH
Rocznik Orientalistyczny	RocO
Rocznik Slawistyczny/Revue Slavistique	RoSlaw
Roman 20-50: Revue d'Etude du Roman du XXe Siècle	RVC
Romance Linguistics & Literature Review	RL&LR
Romance Notes	RomN
Romance Philology	RPh
Romance Quarterly	KRQ
Romanian Review	RoR
Romanic Review	RR
Romanica Gandensia	RomG
Romanische Forschungen	RF
Romanistisches Jahrbuch	RJ
Romanoslavica	RomSl
Romantisme: Revue du Dix-Neuvième Siècle	Romantisme
Room of One's Own: A Feminist Journal of Literature and Criticism	ROO
Rozprawy Komisji Jezykowej	RKJ
RSA Journal: Rivista di Studi Nord-Americani	RSA
Ruch Literacki	RuchL
Ruperto Carola: Heidelberger Universitätshefte	RC
Russian, Croatian and Serbian, Czech and Slovak, Polish Literature	RCSCSPL
Russian Language Journal	RLJ
Russian Linguistics: International Journal for the Study of the Russian Language	RusLing
The Russian Review: An American Quarterly Devoted to Russia Past and Present	RusR
Russkaia Literatura: Istoriko-Literaturnyi Zhurnal	RLit
Russkaia Rech': Nauchno-Populiarnyi Zhurnal	RusRe
Russkii Iazyk v Shkole: Metodicheskii Zhurnal	RJS
Russkii Iazyk za Rubezhom	RJR
Sacred Heart University Review	SHUR
Sacris Erudiri: Jaarboek voor Godsdienstwetenschappen	SacE
SAGE: A Scholarly Journal on Black Women	SAGE
Sagetrieb: A Journal Devoted to Poets in the Imagist/Objectivist Tradition	SagetriebIO
Saint Louis University Research Journal of the Graduate School of Arts and Sciences	SLRJ
Salmagundi	Salmagundi
Samlaren: Tidskrift för Svensk Litteraturvetenskaplig Forskning	Samlaren
Sammlung Metzler	SM
Samtiden: Tidsskrift for Politikk, Litteratur og Samfunnsspørsmål	Samtiden
San José Studies	SJS
Sananjalka: Suomen Kielen Seuran Vuosikirja	Sananjalka
Sapienza: Rivista di Filosofia e di Teologia	Sapienza: Rivista di Filosofia e di Teologia
Savacou: A Journal of the Caribbean Artists Movement	Savacou
Savremenik: Mesecni Knjizevni Casopis	Savremenik
Sborník Prací Filosofické Fakulty Brnenské University: Rada Literárnevedná-D	SPFFBUD
Scandinavian Review	ScanR
Scandinavian Studies	SS
Scandinavica: An International Journal of Scandinavian Studies	Scan
Scando-Slavica	SSl
Scena: Casopis za Pozorisnu Umetnost	Scena
Schatzkammer der Deutschen Sprache, Dichtung und Geschichte	Schatzkammer
Scholarly Publishing: A Journal for Authors and Publishers	SchP
Scholars' Facsimiles & Reprints	SF&R
Schriften der Theodor-Storm-Gesellschaft	SSG
Schweizer VolksKunde: Korrespondenzblatt der Schweizerischen Gesellschaft für Volkskunde	SV
Schweizerisches Archiv für Volkskunde	SAV
Science et Esprit	ScEc
Science Fiction: A Review of Speculative Literature	SFic
Science-Fiction Studies	SFS
Scottish Gaelic Studies	SGS
Scottish Language	ScotL
Scottish Literary Journal	ScLJ
Scottish Studies	ScS
Scottish Text Society	STS
The Scriblerian and the Kit Cats: A Newsjournal Devoted to Pope, Swift, and Their Circle	Scriblerian
Scripsi	Scripsi
Scripta Islandica: Isländska Sällskapets Årsbok	ScI
Scriptorium: Revue Internationale des Etudes Relatives aux Manuscrits/International Review of Manuscript Studies	Scriptorium
The SECOL Review: Southeastern Conference on Linguistics	SECOLB
SECOLAS Annals: Journal of the Southeastern Council on Latin American Studies	SECOLASA
Secolul 20	SXX
Second Language Research	SLRe
Sefarad: Revista de Estudios Hebraicos, Sefardies y de Oriente Proximo	Sefarad
Seges: Etudes et Textes de Philologie et Littérature. Université de Fribourg Suisse/Studien und texte zur Philologie und Literatur. Universität Freiburg Schweiz/Studi e Testi di Filologia e Letteratura. Università di Friburgo Svizzera	Seges
SEL: Studies in English Literature, 1500-1900	SEL
Selecta: Journal of the Pacific Northwest Council on Foreign Languages	Selecta
Selected Bibliographies in Language and Literature	SBLL
Selected Reports in Ethnomusicology	SRIELA
Seminar: A Journal of Germanic Studies	Seminar
Semiotext(e)	Semiotext(e)
Semiotica: Journal of the International Association for Semiotic Studies/Revue de l'Association Internationale de Sémiotique	Semiotica
Serie de Vocabularios y Diccionarios Indigenas "Mariano Silva y Aceves"	SVDI
Serpe: Revista Letteraria	Serpe: Revista Letteraria
The Seventeenth Century	SCen
Seventeenth-Century News	SCN
Sewanee Review	SR
Shakespeare Bulletin: A Journal of Performance Criticism and Scholarship	ShakB
The Shakespeare Newsletter	ShN
Shakespeare Quarterly	SQ
Shakespeare Studies (Albuquerque, NM)	ShakS
Shakespeare Studies (Tokyo)	ShStud
Shakespeare Survey: An Annual Survey of Shakespeare Study and Production	ShS
The Shandean: An Annual Devoted to Laurence Sterne and His Works	Shandean
The Shavian: The Journal of the Shaw Society	Shavian
Shaw: The Annual of Bernard Shaw Studies	ShawR
Shenandoah: The Washington & Lee University Review	Shenandoah
Sight and Sound	Sight&S
Siglo XX/20th Century	Siglo
Sigma: Linguistique Anglaise-Linguistique Générale	Sig
Sign Language Studies	SLS
Signs: Journal of Women in Culture and Society	Signs
Silarus: Rassegna Bimestrale di Cultura	Silarus
Sing Out!: The Folk Song Magazine	Sing Out
Sinn und Form: Beiträge zur Literatur	SuF
Sipario: Il Mensile Italiano dello Spettacolo	Sipario
Sirp ja Vasar	SjV
Sitzungsberichte der Österreichischen Akademie der Wissenschaften in Wien, Philosophisch-Historische Klasse	SÖAW
The Sixteenth Century Journal	SCJ
Skírnir: Tímarit Hins Íslenska Bókmenntafélags	Skírnir
Slavia: Casopis pro Slovanskou Filologii	Slavia
Slavia Orientalis	SlOr
Slavic and East European Arts	SEEA
Slavic and East European Journal	SEEJ
Slavic Review: American Quarterly of Russian, Eurasian and East European Studies	SlavR
Slavisticna Revija	SlR
The Slavonic and East European Review	SEER
Slovakia	Slovakia
Slovene Studies: Journal of the Society for Slovene Studies	SlovS
Slovenský Národopis	SlovN
Slovenská Literatúra: Revue Pre Literárnu Vedu	SlovLit
Slovenská Rec: Casopis Pre Výskum Slovenského Jazyka	SlRec
Slovenské Divadlo: Revue Dramatických Umení	SDi
Slovenské Pohl'ady na Literatúru a Umenie	SlovP
Slovo a Slovesnost	SaS
Slovo: Casopis Staroslavenskog Zavoda u Zagrebu	Slovo
Slovo na Storozhi	SNS
Social Psychology Quarterly	SPsy
Social Science Information/Information sur les Sciences Sociales	SSI
Social Text	SText
Society for the Study of Midwestern Literature Newsletter	SSMLN
Sociocriticism	Sociocriticism	
Sophia	SophiaT
Sophia English Studies	SES
Soundings: An Interdisciplinary Journal	Soundings
Soundings: Collections of the University Library, University of California, Santa Barbara	SCUL
Sources Chrétiennes	SCh
South African Journal of African Languages/Suid-Afrikaanse Tydskrif vir Afrikatale	SAJAL
South Atlantic Quarterly	SAQ
South Atlantic Review	SoAR
South Carolina Review	SCR
South Central Review: The Journal of the South Central Modern Language Association	SCRev
South Dakota Review	SDR
Southerly: A Review of Australian Literature	Southerly
Southern Folklore	SFolk
Southern Humanities Review	SHR
Southern Literary Journal	SLJ
The Southern Quarterly: A Journal of the Arts in the South	SoQ
The Southern Review (Baton Rouge, LA)	SoR
Southern Review: Literary and Interdisciplinary Essays (Adelaide, South Australia)	SoRA
Southern Studies: An Interdisciplinary Journal of the South	SoSt
Southwest Journal of Linguistics	SJL
Southwest Review	SWR
Sovetish Heymland/Sovetskaia Rodina: Ezhemesiachnyi Literaturno-Khudozhestvennyi Zhurnal	SovH
Soviet Literature	SovL
Speculum: A Journal of Medieval Studies	Speculum
Speculum Artium	SArt
Spektator: Tijdschrift voor Neerlandistiek	Spektator
Spenser Studies: A Renaissance Poetry Annual	SSt
Spicilegio Moderno: Letteratura, Lingua, Idee	SpM
Spiegel der Letteren: Tijdschrift voor Nederlandse Literatuurgeschiedenis en voor Literatuurwetenschap	SpL
Spirit: A Magazine of Poetry	Spirit
Sprache im Technischen Zeitalter	SiTZ
Sprache und Datenverarbeitung: International Journal for Language Data Processing	SDv
Sprachkunst: Beiträge zur Litteraturwissenschaft	Sprachkunst
Sprachspiegel: Schweizerische Zeitschrift für die deutsche Muttersprache	Spsp
Sprachwissenschaft	Sprachwiss
Språkvård: Tidskrift Utgiven av Svenska Språknämnden	Språkvård
Stanford French Review	SFR
Stanford German Studies	SGerS
Stanford Slavic Studies	StSS
Stasinos: The Bulletin of the Greek Philologists	Stasinos
Steaua	Steaua
Steinbeck Monograph Series	StMS
Steinbeck Quarterly	StQ
Stendhal Club: Revue Internationale d'Etudes Stendhaliennes. Nouvelle Série. Revue Trimestrielle	SC
Stimmen der Zeit	SZ
Stockholm Studies in English	SSEL
Studi Danteschi	SD
Studi di Filologia Italiana: Bollettino Annuale dell'Accademia della Crusca	SFI
Studi di Grammatica Italiana	StGrI
Studi di Letteratura Ispano-Americana	SLIA
Studi e Problemi di Critica Testuale	SPCT
Studi e Saggi Linguistici	SeSL
Studi Francescani: Trimestrale di Vita Culturale e Religiosa a Cura dei Frati Minori d'Italia	SFran
Studi Francesi	SFr
Studi Germanici	StG
Studi Italiani di Linguistica Teorica ed Applicata	SILTA
Studi Medievali	SMed
Studi Mediolatini e Volgari	SMV
Studi Romani: Rivista Trimestrale dell'Istituto Nazionale di Studi Romani	SRo
Studi Secenteschi	SSe
Studi sul Boccaccio	SBoc
Studi Trentini di Scienze Storiche	STr
Studia Anglica Posnaniensia: An International Review of English Studies	SAP
Studia Celtica	StC
Studia Fennica Ethnologica	SFenE
Studia Fennica Folkloristica	SFenF
Studia Fennica Linguistica	SFenL
Studia Hibernica	SH
Studia Iranica	StudiaI
Studia Islamica	StIsl
Studia Islandica: Íslenzk Fræõi	StudIsl
Studia Linguistica	SL
Studia Logica: An International Journal for Symbolic Logic	SLog
Studia Monastica	StM
Studia Neophilologica: A Journal of Germanic and Romance Languages and Literature	SN
Studia Phonetica	SPh
Studia Slavica Academiae Scientiarum Hungaricae	SSASH
Studia Slavica Finlandensia	SSFin
Studia Staropolskie	StuSta
Studiekamraten	Studiekamraten
Studien und Texte zur Sozialgeschichte der Literatur	STSL
Studien zu den Bogazköy-Texten	StBoT
Studier i Modern Språkvetenskap	SMS
Studies: An Irish Quarterly Review	Studies
Studies in African Linguistics	SAL
Studies in American Drama, 1945-Present	SAD
Studies in American Fiction	SAF
Studies in American Humor	StAH
Studies in American Jewish Literature	SAJL
Studies in Bibliography: Papers of the Bibliographical Society of the University of Virginia	SB
Studies in Browning and His Circle: A Journal of Criticism, History, and Bibliography	SBHC
Studies in Canadian Literature/Etudes en Littérature Canadienne	SCL
Studies in Contemporary Satire: A Creative and Critical Journal	StCS
Studies in Descriptive Linguistics	SDL
Studies in Eighteenth-Century Culture	SECC
Studies in English and Comparative Literature	SECL
Studies in English Language and Literature (Seinan Gakuin University)	SELL-SG
Studies in English Literature	SELit
Studies in German Literature, Linguistics, and Culture	SGLLC
Studies in Language: International Journal Sponsored by the Foundation "Foundations of Language"	SLang
Studies in Latin American Popular Culture	SLAPC
Studies in Medieval English Language and Literature	SMELL
Studies in Philology	SP
Studies in Puritan American Spirituality	SPAS
Studies in Religion/Sciences Religieuses: Revue Canadienne/A Canadian Journal	SRC
Studies in Romanticism	SIR
Studies in Scottish Literature	SSL
Studies in Second Language Acquisition	SSLA
Studies in Short Fiction	SSF
Studies in Slavic and General Linguistics	SSGL
Studies in Slavic Literature and Poetics	SSLP
Studies in the Age of Chaucer: The Yearbook of the New Chaucer Society	SAC
Studies in the American Renaissance	SAR
Studies in the Literary Imagination	SLitI
Studies in the Novel	SNNTS
Studies in Twentieth Century Literature	StTCL
Studies in Weird Fiction	StWF
Studies on Voltaire and the Eighteenth Century	SVEC
Studii si Cercetari Lingvistice	StCL
Studium	Studium
Stuttgarter Arbeiten zur Germanistik	SAG
Stvaranje: Casopis za Knjizevnost i Kulturu	Stvaranje
Style	Style
SubStance: A Review of Theory and Literary Criticism	SubStance
Sudetenland	Sudetenland
Sumlen: Årsbok för Vis- och Folkmusikforskning	Sumlen
Suomalaisen Kirjallisuuden Seuran Toimituksia	SKS
Suomen Antropologi/Antropologi i Finland	SAnt
Suplementos Anthropos: Materiales de Trabajo Intelectual	SupA
Supostavitelno Ezikoznanie/Sopostavitel'noe Jazykoznanie/Contrastive Linguistics	SEzik
Surfaces [Electronic publication]	Surfaces
Susquehanna University Studies	SUS
Suvremena Lingvistika	SuvL
Svenska Landsmål och Svenskt Folkliv	SLSF
Svensklärarföreningens Årsskrift	SlfÅ
Svoboda: Ukrainian Daily	Svoboda
Swedish-American Historical Quarterly	SAHQ
Swedish Book Review	SBR
Swiss Papers in English Language and Literature	SPELL
Sydsvenska Ortnamnssällskapets Årsskrift/The Annual Journal of the South Swedish Place-Name Society	SOÅ
Symposium: A Quarterly Journal in Modern Foreign Literatures	Symposium
Syn og Segn: Norsk Tidsskrift	SoS
Synthese: An International Journal for Epistemology, Methodology and Philosophy of Science	Synthese
Synthesis: Bulletin du Comité National Roumain de Littérature Comparée et de l'Institut d'Histoire et de Théorie Littéraire "G. Clainescu" de l'Académie Roumaine	Synthesis
Syracuse University Library Associates Courier	Courier
Szinház: Theatre, Theoretical and Critical Journal of Theatrical Arts	Szinház
T. A. Informations: Revue Internationale du Traitement Automatique du Langage	TAI
T'oung Pao: Revue Internationale de Sinologie	TPA
Taal en Tongval	TeT
Talisman: A Journal of Contemporary Poetry and Poetics	Talisman
Tamarack: Journal of the Edna St. Vincent Millay Society	Tamarack
Tamkang Review: A Quarterly of Comparative Studies between Chinese and Foreign Literatures	TkR
Tarbiz: A Quarterly for Jewish Studies	Tarbiz
Target: International Journal of Translation Studies	Target
TDR: The Drama Review: A Journal of Performance Studies	TDRev
Teatro del Siglo de Oro: Ediciones Crítcas	TSO
Teksty Drugie: Teoria Literatury-Krytyka-Interpretacja	TekstyD
Temenos: Studies in Comparative Religion Presented by Scholars in Denmark, Finland, Norway and Sweden	Temenos
Temps Modernes	TM
Tennessee Folklore Society Bulletin	TFSB
Tennessee Studies in Literature	TStL
The Tennyson Research Bulletin	TRB
Teología Espiritual	TE
Teoría Litéraria: Texto y Teoria	TLit
TESOL Quarterly	TESOLQ
Tessera	Tessera
The Texas Review	TexasR
Texas Studies in Literature and Language	TSLL
Text and Performance Quarterly	TPQ
Text + Kritik: Zeitschrift für Literatur	TuK
Text: Transactions of the Society for Textual Scholarship	Text
Texte der Hethiter	THeth
Texte: Revue de Critique et de Théorie Littéraire	Texte
Textes Littéraires Français	TLF
Texto Crítico	TCrit
Textual Practice	TexP
Textus: Annual of the Hebrew University Bible Project	Textus
Thalia: Studies in Literary Humor	Thalia
Theater	Theater
TheaterZeitSchrift: Beiträge zu Theater, Medien, Kulturpolitik	TZS
Theatre Annual	TA
Theatre History in Canada/Histoire du Théâtre au Canada	THIC
Theatre History Studies	THStud
Theatre Journal	TJ
Theatre Notebook: A Journal of the History and Technique of the British Theatre	TN
Theatre Research International	ThR
Theatre Studies	TheatreS
Theatre Survey: The Journal of the American Society for Theatre Research	ThS
Themes in Drama	ThD
Theoria: A Journal of Studies in the Arts, Humanities and Social Sciences	Theoria
Thesaurismata	Thesaurismata
Thesaurus: Boletín del Instituto Caro y Cuervo	Thesaurus
Third Rail: A Review of International Arts & Literature	ThirdR
The Thomas Hardy Journal	THJ
The Thomas Hardy Yearbook	THY
Thomas Mann Jahrbuch	TMJ
Thomas-Mann-Studien	ThMS
The Thomas Wolfe Review	TWN
Thoreau Society Bulletin	TSB
Thought: A Review of Culture and Idea	Thought
Tidskrift för Litteraturvetenskap	TfL
Tijdschrift voor Nederlandse Taal- en Letterkunde	TNTL
Tirade	Tirade
Tlalocan: Revista de Fuentes para el Conocimiento de las Culturas Indigenas de México	Tlalocan
Tohogaku: Eastern Studies	Tohogaku
Tohoku Gakuin University Review: Essays and Studies in English Language and Literature [Tohoku Gakuin Daigaku Ronshu, Eigo- Eibungaku]	ESELL
Tolstoy Studies Journal	TSJ
Tools & Tillage: A Journal on the History of the Implements of Cultivation and Other Agricultural Processes	T&T
Topic: A Journal of the Liberal Arts	Topic
Topics in Sociolinguistics	TiS
La Torre: Revista de la Universidad de Puerto Rico	Torre
Trabalhos em Linguistica Aplicada	TLA
Tradisjon: Tidsskrift for Folkeminnevitskap	Tradisjon
Traditio: Studies in Ancient and Medieval History, Thought, and Religion	Traditio
Tradition: A Journal of Orthodox Jewish Thought	Tradition
Traditiones: Zbornik Instituta za Slovensko Narodopisje	TZI
The Transactions of the Asiatic Society of Japan	TASJ
Transactions of the Cambridge Bibliographical Society	TCBS
Transactions of the Gaelic Society of Inverness	TGSI
Transactions of the Honourable Society of Cymmrodorion	THSC
Transactions of the Philological Society	TPS
Transactions of the Wisconsin Academy of Sciences, Arts, and Letters	TWA
Transactions of the Yorkshire Dialect Society	TYDS
Translation	Translation
Translation Review	TRev
Travaux d'Humanisme et Renaissance	THR
Travaux de Linguistique: Revue Internationale de Linguistique Française	TL
Travaux de Littérature	TraLit
Travaux du CIEREC (Centre Interdisciplinaire d'Etudes et de Recherches sur l'Expression Contemporaine)	TrCIEREC
Travessia	Travessia
Trimestre	Trimestre
TriQuarterly	TriQ
Tristania: A Journal Devoted to Tristan Studies	Tristania: A Journal Devoted to Tristan Studies
Triveni: Journal of Indian Renaissance	Triveni
Tropelías: Revista de Teoria de la Literatura y Literatura Comparada	Tropelías
Tsing Hua Journal of Chinese Studies	THJCS
Tulimuld: Eesti Kirjanduse ja Kultuuri Ajakiri	Tulimuld
Tulsa Studies in Women's Literature	TSWL
Twayne's English Authors Series	TEAS	
Twayne's United States Authors Series	TUSAS
Twentieth Century Literature: A Scholarly and Critical Journal	TCL
Twórczosc	Tw
Tydskrif vir Geesteswetenskappe	TvG
Tydskrif vir Letterkunde	TvL
Ukrainian Quarterly: Journal of East European and Asian Affairs	UQ
The Ukrainian Review: A Quarterly Journal Devoted to the Study of the Ukraine	UkrR
Ukraïns'ke Literaturoznavstvo: Mizhvidomchyi Respublikans'kyi Zbirnyk	ULz
Ukraïns'ke Movoznavstvo: Mizhvidomchyi Naukovyi Zbirnyk	UkrMov
Ukraïns'kyi Istoryk	UkrI
Ulster Folklife	UF
ULULA: Graduate Studies in Romance Languages	ULULA
Umma: A Magazine of Original Writing	Umma
Unilit	Unilit
Unisa English Studies: Journal of the Department of English	UES
Unitas: A Quarterly for the Arts and Sciences	Unitas
Universitas: Zeitschrift für Wissenschaft, Kunst und Literatur	Univ
University of Dayton Review	UDR
University of Florida Monographs, Humanities Series	UFMH
University of Hartford Studies in Literature: A Journal of Interdisciplinary Criticism	HSL
University of Kansas Humanistic Studies	UKPHS
University of Leeds Review	ULR
University of Mississippi Studies in English	UMSE
University of North Carolina Studies in Comparative Literature	UNCSCL
University of North Carolina Studies in the Germanic Languages and Literatures	UNCSGLL
University of Toronto Quarterly: A Canadian Journal of the Humanities	UTQ
Uomini e Libri: Periodico Bimestrale di Critica ed Informazione Letteraria	UeL
The Upstart Crow	UCrow
Ural-Altaische Jahrbücher/Ural-Altaic Yearbook: Internationale Zeitschrift für Nord-Eurasien	UAJ
Urbe: Rivista Romana di Storia, Arte, Lettere, Costumanze	Urbe
Utah Studies in Literature and Linguistics	USLL
Vagant	Vagant
Vargartha: Critical Quarterly of Indian Literature	Vagartha
Varieties of English Around the World	VEAW
The Velvet Light Trap	VLT
Verbatim: The Language Quarterly	Verbatim
Verdad y Vida: Revista de las Ciencias del Espiritu	VyV
Veröffentlichungen der Abteilung für Slavische Sprachen und Literaturen des Osteuropa-Instituts (Slavisches Seminar) an der Freien Universität Berlin	VOEI
Vestnik Moskovskogo Universiteta. Seriia 9, Filologiia	VMU
Vetenskaps-Societeten i Lund Årsbok	VSLÅ
Vetera Christianorum	VChrist
Viata Româneasca	ViR
Viator: Medieval and Renaissance Studies	Viator
Victorian Literature and Culture	VLC
Victorian Newsletter	VN
Victorian Periodicals Review	VPR
Victorian Poetry	VP
Victorian Studies: A Journal of the Humanities, Arts and Sciences	VS
Vigiliae Christianae: A Review of Early Christian Life and Language	VigC
VIJ: Victorians Institute Journal	VIJ
Vinduet	Vinduet
Virginia Cavalcade	VC
Virginia Quarterly Review: A National Journal of Literature and Discussion	VQR
Virginia Woolf Miscellany	VWM
Virittäjä: Journal de Kotikielen Seura	Vir
Visible Language: The Quarterly Concerned with All That is Involved in Our Being Literate	VLang
Vitchyzna: Literaturno-Khudozhnii ta Hromads'ko-Politychnyi Misiachnyk	Vitchyzna
Vivarium: An International Journal for the Philosophy and Intellectual Life of the Middle Ages and Renaissance	Vivarium
Voix et Images: Littérature Québécoise	V&I
Volkskunde: Driemaandelijks Tijdschrift voor de Studie van het Volksleven	Volkskunde
Voprosy Iazykoznaniia (Moscow)	VJa
Voprosy Literatury	VLit
Vox Romanica: Annales Helvetici Explorandis Linguis Romanicis Destinati	VR
Vsesvit: Zhurnal Inozemnoï Literatury. Literaturno-Mystets'kyi ta Hromads'ko-Politychnyi Misiachnyk. Orhan Spilky Pys'mennykiv Ukraïny, Ukraïns'koho Tovarystva Druzhby i Kul'turnykh Zv'iazkiv z Zarubizhnymy Kraïnamy, Ukraïns'koï Rady Myru	Vsesvit
Vuelta	Vuelta
[vwa]	vwa
Vyzvol'nyi Shliakh/Liberation Path	VyzSh
Waiguoyu	Waiguoyu
The Wallace Stevens Journal: A Publication of the Wallace Stevens Society	WSJour
Walt Whitman Quarterly Review	WWQR
Wascana Review	WascanaR
Weber Studies: An Interdisciplinary Humanities Journal	WStu
Weimarer Beiträge: Zeitschrift für Literaturwissenschaft, Ästhetik und Kulturwissenschaften	WB
West Georgia College Review	WGCR
Westerly: A Quarterly Review	Westerly
Western American Literature	WAL
Western Folklore	WF
Western Humanities Review	WHR
Western Writers Series	WWS
Wetenschappelijke Tijdingen op het Gebied van de Geschiedenis van de Vlaamse Beweging	WT
The Wicazo SA Review: A Journal of Indian Studies	WSaR
Wide Angle: A Film Quarterly of Theory, Criticism, and Practice	WAn
Wiener Arbeiten zur Deutschen Literatur	WADL
Wiener Beiträge zur Englischen Philologie	WBEP
Wiener Slavistisches Jahrbuch	WSJ
Wiener Zeitschrift für die Kunde Südasiens und Archiv für Indische Philosophie	WZKS
Willa Cather Pioneer Memorial Newsletter	WCPMN
The William and Mary Quarterly: A Magazine of Early American History and Culture	WMQ
William Carlos Williams Review	WCWR
Winterthur Portfolio: A Journal of American Material Culture	WPo
Wirkendes Wort: Deutsche Sprache und Literatur in Forschung und Lehre	WWort
Wissenschaftliche Zeitschrift der Humbolt-Universität zu Berlin. Gesellschaftswissenschaftliche Reihe	WZUB
Wissenschaftliche Zeitschrift der Martin-Luther Universität Halle-Wittenberg. Gesellschafts- und Sprachwissenschaftliche Reihe	WZUH
Wissenschaftliche Zeitschrift der Wilhelm-Pieck-Universität Rostock. Gesellschaftswissenschaftliche Reihe	WZUR
Wolfenbütteler Barock-Nachrichten	WBN
Wolfenbütteler Beiträge: Aus den Schätzen der Herzog August Bibliothek	WolfenbüttelerB
Wolfenbütteler Studien zur Aufklärung	WSA
Women and Language	W&Lang
Women in German Yearbook: Feminist Studies in German Literature and Culture	WGY
Women & Performance: A Journal of Feminist Theory	W&P
Women's Studies: An Interdisciplinary Journal	WS
Word & Image: A Journal of Verbal/Visual Enquiry	W&I
WORD: Journal of the International Linguistic Association	Word
Word Ways: The Journal of Recreational Linguistics	WWays
The Wordsworth Circle	WC
Working Papers in Linguistics	WPL
Works and Days: Essays in the Socio-Historical Dimensions of Literature and the Arts	W&D
World Literature Today: A Literary Quarterly of the University of Oklahoma	WLT
World Literature Written in English	WLWE
Xavier Review	XUS
Y Traethodydd	Y Traethodydd
Yale French Studies	YFS
The Yale Journal of Criticism: Interpretation in the Humanities	YJC
Yale Journal of Law & the Humanities	YJLH
The Yale Review	YR
Yale University Library Gazette	YULG
Year's Work in English Studies	YWES
The Year's Work in Modern Language Studies	YWMLS
Yearbook for Traditional Music	YTM
Yearbook of Comparative and General Literature	YCGL
Yearbook of English Studies	YES
Yearbook of Italian Studies	YIS
The Yearbook of Langland Studies	YLS
Yeates Eliot Review: A Journal of Criticism and Scholarship	YER
Yeats: An Annual of Critical and Textual Studies	Yeats
Yeats Annual	YeA
Yiddish	Yiddish
Yiddishe Kultur	YK
Z Dziejów Form Artystycznych W Literaturze Polskiej	ZDFALP
Z: Filmtidsskrift	Z
Zadarska Revija: Casopis za Kulturu i Drustvena Pitanja	ZR
Zagadnienia Rodzajów Literackich: Woprosy Literaturnych Zanrov/Les Problèmes des Genres Littéraires	ZRL
Zeitschrift für Anglistik und Amerikanistik	ZAA
Zeitschrift für Deutsche Philologie	ZDP
Zeitschrift für Deutsches Altertum und Deutsche Literatur	ZDA
Zeitschrift für Dialektologie und Linguistik	ZDL
Zeitschrift für Französische Sprache und Literatur	ZFSL
Zeitschrift für Germanistik	ZG
Zeitschrift für Germanistische Linguistik	ZGL
Zeitschrift für Katalanistik: Revista d'Estudis Catalans	ZfK
Zeitschrift für Ostforschung: Länder und Völker im Östlichen Mitteleuropa	ZOF
Zeitschrift für Romanische Philologie	ZRP
Zeitschrift für Slawistik	ZS
Zeitschrift für Volkskunde: Halbjahreschrift der Deutschen Ges. f. Volkskunde	ZV
Zeszyty Literackie	ZL
Zeta: Rivista Internazionale di Poesia	Zeta
Zielsprache Deutsch: Zeitschrift für Unterrichtsmethodik und Angewandte Sprachwissenschaft	ZD
Ziva Antika	ZA
Zivot: Casopis za Knjizevnost i Kulturu	Zivot
Znamenje	
Zvezda	

